0	Z IY R OW
1	W AH N
10	W AH N Z IY R OW
100	W AH N Z IY R OW Z IY R OW
1000	W AH N Z IY R OW Z IY R OW Z IY R OW
11	W AH N W AH N
12	W AH N T UW
13	W AH N TH R IY
14	W AH N F OW R
15	W AH N F AY V
16	W AH N S IH K S
17	W AH N S EH V AH N
18	W AH N EY T
19	W AH N AY N
2	T UW
20	T UW Z IY R OW
200	T UW Z IY R OW Z IY R OW
21	T UW W AH N
22	T UW T UW
23	T UW TH R IY
24	T UW F OW R
25	T UW F AY V
26	T UW S IH K S
27	T UW S EH V AH N
28	T UW EY T
29	T UW N AY N
3	TH R IY
30	TH R IY Z IY R OW
31	TH R IY W AH N
32	TH R IY T UW
33	TH R IY TH R IY
34	TH R IY F OW R
35	TH R IY F AY V
36	TH R IY S IH K S
37	TH R IY S EH V AH N
38	TH R IY EY T
39	TH R IY N AY N
4	F OW R
40	F OW R Z IY R OW
41	F OW R W AH N
42	F OW R T UW
43	F OW R TH R IY
44	F OW R F OW R
45	F OW R F AY V
46	F OW R S IH K S
47	F OW R S EH V AH N
48	F OW R EY T
485	F OW R EY T F AY V
49	F OW R N AY N
5	F AY V
50	F AY V Z IY R OW
500	F AY V Z IY R OW Z IY R OW
51	F AY V W AH N
518	F AY V W AH N EY T
52	F AY V T UW
53	F AY V TH R IY
54	F AY V F OW R
55	F AY V F AY V
56	F AY V S IH K S
57	F AY V S EH V AH N
58	F AY V EY T
59	F AY V N AY N
6	S IH K S
60	S IH K S Z IY R OW
601	S IH K S Z IY R OW W AH N
61	S IH K S W AH N
62	S IH K S T UW
63	S IH K S TH R IY
64	S IH K S F OW R
65	S IH K S F AY V
66	S IH K S IH K S
67	S IH K S EH V AH N
68	S IH K S EY T
69	S IH K S N AY N
7	S EH V AH N
70	S EH V AH N Z IY R OW
71	S EH V AH N W AH N
72	S EH V AH N T UW
73	S EH V AH N TH R IY
74	S EH V AH N F OW R
75	S EH V AH N F AY V
76	S EH V AH N S IH K S
77	S EH V AH N S EH V AH N
78	S EH V AH N EY T
79	S EH V AH N AY N
8	EY T
80	EY T Z IY R OW
81	EY T W AH N
82	EY T UW
83	EY T TH R IY
84	EY T F OW R
85	EY T F AY V
86	EY T S IH K S
87	EY T S EH V AH N
88	EY T EY T
89	EY T N AY N
9	N AY N
90	N AY N Z IY R OW
91	N AY N W AH N
92	N AY N T UW
93	N AY N TH R IY
94	N AY N F OW R
95	N AY N F AY V
96	N AY N S IH K S
97	N AY N S EH V AH N
98	N AY N EY T
99	N AY N AY N
A	AH
A(2)	EY
A	AH
A(2)	EY
AA	AA
AABADI	AA B AH D IY
AAD	AA D
AADMI	AA D M IY
AAG	AA G
AAGAH	AA G AH
AAGE	AH EY JH
AAGEY	AH EY JH IY
AAGHAZ	AA AH Z
AAI	AA IY
AAIYE	AA IY AY
AAJ	AA JH
AAJAH	AA JH AH
AAKHIR	AA K AH R
AAKHRI	AA K R IY
AALA	AA L AH
AALISHAAN	AH L IH SH EY AH N
AALMI	AA L M IY
AAM	AA M
AAMAJGAH	AH M AE JH AH
AAMDNI	AA M D N IY
AANAR	AA N AH R
AANE	AA N
AANGAN	AA N G AH N
AANKH	AA NG K
AANKHEN	AA NG K AH N
AANKHN	AA NG K N
AANKHON	AA NG K AH N
AANSOO	AA N S UW
AAP	AA P
AARR	AA R
AARZI	AA R Z IY
AASAAN	AA S EY AH N
AASHIQ	AA SH AH K
AASRA	AA Z R AH
AATH	AA TH
AATHWAN	AA TH W AH N
AATHWIEN	AA TH W IY AH N
AATI	AA T IY
AATSHEEN	AA T IY AH N
AAUR	AA AH R
AAWAZ	AA W AH Z
AAYA	AA AY AH
AAZH	AA Z
AAZMAYEN	AA Z M EY AH N
AB	AE B
ABAD	AH B AA D
ABAO	AE B EY OW
ABDOZEN	AE B D AH Z AH N
ABDULHAI	AE B D AH L HH EY
ABHI	AE B HH IY
ABID	EY B IH D
ABIYANA	EY B IY AY AH N AH
ABJAD	AE B AH D
ABLE	EY B AH L
ABOUT	AH B AW T
ABRAR	AE B R AH R
ABRO	AE B R OW
ABRRO	AE B R OW
ABSAAR	AE B S EY AH R
ABSHAR	AE B SH AH R
ABU	AE B UW
ABWAAB	AE B W AH B
ABZAROR	AE B Z AH R AH R
ACCENT	AH K S EH N T
ACCENT(2)	AE K S EH N T
ACCIDENT	AE K S AH D AH N T
ACHA	AE CH AH
ACHAI	AE CH EY
ACHAMBE	AE CH AH M
ACHANAK	AE CH AH N AH K
ACHAT	AH CH AE T
ACHAY	AE CH EY IY
ACHE	EY K
ACHEY	AE CH IY
ACHI	AE CH IY
ACHIEVEMENT	AH CH IY V M AH N T
ACID	AE S AH D
ACTUALLY	AE K CH UW AH L IY
ACTUALLY(2)	AE K CH L IY
ACTUALLY(3)	AE K SH AH L IY
ADA	EY D AH
ADAB	AH D AE B
ADAD	AH D AE D
ADAEGI	AH D IY JH IY
ADAKARAEIN	AE D AH K AE R IY AH N
ADAKARAON	AE D AH K AE R EY AH N
ADAL	EY D AH L
ADALT	AE D AH L T
ADAM	AE D AH M
ADAYIGYON	AE D EY IH JH AY AH N
ADDE	AE D
ADDED	AE D IH D
ADDITIONAL	AH D IH SH AH N AH L
ADDO	AE D OW
ADDRESS	AE D R EH S
ADEEBON	EY D IY B AH N
ADHA	AE D HH AH
ADHAY	AE D HH EY IY
ADHI	AE D HH IY
ADHOORA	AE D HH AH R AH
ADJUST	AH JH AH S T
ADLIYA	AE D L IY AY AH
ADMI	AE D M IY
ADVANCED	AH D V AE N S T
ADVENTURE	AE D V EH N CH ER
ADVENTURE(2)	AH D V EH N CH ER
ADVERTISING	AE D V ER T AY Z IH NG
ADVICE	AE D V AY S
ADVICE(2)	AH D V AY S
ADVISERY	AH D V AY Z AH R IY
ADVOCATE	AE D V AH K AH T
ADVOCATE(2)	AE D V AH K EY T
ADWIYAAT	AE D W IY AY AH T
AE	EY
AEEN	EH AH N
AFADAH	AE F AH D AH
AFEEM	EY F IY M
AFFORD	AH F AO R D
AFGHAN	AE F G AE N
AFIYON	EY F IY AY AH N
AFKAR	AE F AH R
AFOO	AE F UW
AFRAAD	AE F R AH D
AFRAD	AE F R AH D
AFRAHS	AE F R AH Z
AFREEDI	AE F R AH D IY
AFREEN	AE F R IY AH N
AFRO	AE F R OW
AFSANEY	AE F S EY N IY
AFSHAN	AE F AH N
AFSOOSNAAK	AE F S UW Z N AH K
AFSOS	AE F S AH Z
AFSURDA	AE F S AH R D AH
AFTER	AE F T ER
AFWAAJ	AE F W AH JH
AFZAISH	AE F Z EY AH SH
AFZAL	AE F Z AH L
AFZAN	AE F Z AH N
AFZODGI	AE F Z AA JH IY
AFZON	AE F Z AH N
AGAIN	AH G EH N
AGAIN(2)	AH G EY N
AGAR	EY G ER
AGARCHAY	AH G AA R K EY IY
AGAWAH	AE G AH AH
AGAY	AH G EY
AGENCIES	EY JH AH N S IY Z
AGENCION	EY JH AH N S IY AH N
AGENCY	EY JH AH N S IY
AGHA	AE AH
AGHOSH	AE AH SH
AGHRAAZ	AE R AH Z
AGHWA	AE W AH
AGHYAR	AE AY AH R
AGLAY	AE G L EY IY
AGLI	AE G L IY
AGO	AH G OW
AHAAM	AE HH AH M
AHAL	AE AH L
AHAM	AH HH AE M
AHC	AE K
AHELKAR	AH HH EH L K AH R
AHEM	AH HH EH M
AHISTA	AH HH IH S T AH
AHIYA	AH HH IY AY AH
AHL	AA L
AHLIAT	AE L IY AH T
AHMED	AA M AH D
AHMED(2)	AA M EH D
AHSAN	AE Z AH N
AHTAMAAM	AE T AH M AH M
AHWAAL	AE W EY AH L
AI	AY
AI(2)	EY AY
AIB	EY B
AIDS	EY D Z
AIESE	EY IY Z
AIK	EY K
AILAAN	EY L EY AH N
AIN	AH IH N
AINDA	EY N D AH
AIR	EH R
AIRHI	AE AH R IY
AISA	AY IY S AH
AISAY	EY S EY IY
AISI	EY S IY
AISIAYON	EY S IY EY AH N
AITAMAT	EY T AH M AH T
AITARAF	EY T AH R AH F
AITEBAR	EY T AH B AH R
AIZAAZ	EY Z AH Z
AJ	AE JH
AJAR	AH JH AA R
AJDAD	AE JH D AH D
AJDAHA	AE JH D AH HH AH
AJEEB	EY JH IY B
AJNABIYON	AE JH N AH B IY AY AH N
AJSAAM	AE JH S AH M
AJZA	AE JH Z AH
AKHAND	AE K AH N D
AKHAR	AE K AH R
AKHBAAR	AE K B EY AH R
AKHLAQI	AE K L AH K IY
AKHONDZADAH	AE K AA N D Z AH D AH
AKHOOAT	AE K UW AH T
AKHRI	AE K R IY
AKHROT	AE K R AH T
AKHRUZAMAN	AE K R UW Z AH M AH N
AKHTAR	AE K T ER
AKMIYON	AE K M IY AY AH N
AKRAM	AE K R AH M
AKS	AE K S
AKSARIYAT	AE K S AH R IY AY AH T
ALAM	AH L AE M
ALAMIYE	AH L EY M IY AY
ALCI	AE L S IY
ALEHDA	AE L AH D AH
ALEO	AA L IY OW
ALETE	AH L IY T
ALFAAZ	AE L F AH Z
ALHAAJ	AE L HH AH JH
ALI	AA L IY
ALIF	AE L AH F
ALIKUM	AE L AH K AH M
ALL	AO L
ALLAH	AA L AH
ALLAH	AA L AH
ALLAH-HAAFIZ	AA L AH HH AA F AH Z
ALLAH-HAFIZ	AA L AH HH AE F AH Z
ALLAHHAFIZ	AE L AE HH AH F AH Z
ALLAH-HAFIZ	AA L AH HH AE F AH Z
ALLAMA	AE L AH M AH
ALLOWANCE	AH L AW AH N S
ALMOST	AO L M OW S T
ALOOCHA	AH L UW CH AH
ALOOD	AH L UW D
ALOODGI	AH L UW JH IY
ALPHABET	AE L F AH B EH T
ALPHABETS	AE L F AH B EH T S
ALREADY	AO L R EH D IY
ALREADY(2)	AO R EH D IY
ALRIGHT	AO L R AY T
ALSO	AO L S OW
ALVI	AE L V IY
ALVIDA	AE L V AH D AH
ALWAYS	AO L W EY Z
ALWAYS(2)	AO L W IY Z
AM	AE M
AM(2)	EY EH M
AMAD	AH M AE D
AMAL	AH M AA L
AMAN	AA M AH N
AMARTA	AH M AA R T AH
AMBULANCE	AE M B Y AH L AH N S
AMDANI	AE M D AH N IY
AMEEQ	EY M IY K
AMERICA	AH M EH R IH K AH
AMERICY	AH M IH ER IH K S N IY
AMEZEY	AH M IY Z IY
AMEZISH	AE M AH Z AH SH
AMIN	AA M IY N
AMJAD	AE M JH AH D
AMLAN	AE M L AH N
AMLI	AE M L IY
AMMI	AE M IY
AMNA	AE M N AH
AMRATSARI	AE M R AE T S AH R IY
AMROHI	AE M R AH HH IY
AMROOD	AE M R UW D
AN	AE N
AN(2)	AH N
ANA	AA N AH
ANA(2)	AE N AH
ANAARI	AE N AH R IY
AND	AH N D
AND(2)	AE N D
ANDAAZ	AE N D AH Z
ANDAR	AE N D AH R
ANDHA	AE N D HH AH
ANDHE	AE N D HH
ANDHERE	AE N D HH AH R
ANDHERON	AE N D HH AH R AH N
ANDHIYAN	AE N D HH IY AY AH N
ANDIA	AE N D IY AH
ANEEQ	EY N IY K
ANEES	EY N IY Z
ANESTHESIA	AE N IH S TH IY ZH IY AH
ANGEKHT	AE N JH AH K T
ANGLO	AE NG G L OW
ANGOOR	AE N G OW AH R
ANGREZI	AE N G R AH Z IY
ANGREZON	AE N G R AH Z AH N
ANGUSHT	AE N G AH SH T
ANIMATED	AE N AH M EY T IH D
ANJAAM	AE N JH AH M
ANJUMAN	AE N JH UW M AH N
ANKHEN	AE NG K AH N
ANKHON	AE NG K AH N
ANKLOSR	AE NG K L AH Z R
ANOKHE	AE N AH K
ANOKHI	AH N AA K IY
ANOTHER	AH N AH DH ER
ANSUON	AE N S UW W AH N
ANWAR	AE N W AA R
ANWAR(2)	AA N W AA R
ANXIETY	AE NG Z AY AH T IY
ANY	EH N IY
AO	EY OW
AOGA	EY AH G AH
AOGAY	EY AA G EY IY
AOGI	EY AH JH IY
AOT	EY AH T
AP	AE P
APEALEN	AH P IY L AH N
APHARA	AE F AH R AH
APKA	AE P AH
APKI	AE P IY
APKO	AE P OW
APNA	AE P N AH
APNAY	AE P N EY IY
APNAYE	AE P N EY
APNE	AE P N
APNI	AE P N IY
APP	AE P
APPLICATIONS	AE P L AH K EY SH AH N Z
APPOINTMENT	AH P OY N T M AH N T
APRIL	EY P R AH L
APROACH	AE P R OW CH
APSAY	AE P S EY IY
APSUB	AE P S AH B
AQA	AE K AH
AQALMANDI	AE K AH L M AE N D IY
AQAON	AE K EY AH N
AQEEL	AH K IY L
AQLIYATON	AE K L IY AY AH T AH N
AQUBAT	AE K W B AH T
AQWAM	AE K W AH M
ARAB	AE R AH B
ARAB(2)	EY R AH B
ARABIC	AE R AH B IH K
ARABIC(2)	EH R AH B IH K
ARAHA	AE R AH HH AH
ARAHE	AE R AH HH
ARCHIVES	AA R K AY V Z
ARDASHT	AA R D AH SH T
ARE	AA R
ARE(2)	ER
AREA	EH R IY AH
ARHA	AA R AH
ARHAI	AA R EY
ARHE	AA R
ARHSATH	AA R S AH TH
ARHTTALIIS	AA R T EY L IY AH S
ARHTTIS	AA R T AH S
ARJUMAND	AA R JH UW M AH N D
ARKAAN	AA R K EY AH N
ARMGHAN	AA R M AH N
AROO	AE R UW
ARRAY	ER EY
ARRHHTALIS	AE R HH T AH L AH S
ARRHTALIIS	AE R T EY L IY AH S
ARRHTALIS	AE R T AH L AH S
ARRHTEES	AE R T IY Z
ARRHTIIS	AE R T IY AH S
ARROW	AE R OW
ARROW(2)	EH R OW
ARSA	AA R S AH
ARSAAL	AA R S EY AH L
ARSATH	AA R S AH TH
ARSEY	AA R Z IY
ARSHAD	AA R SH AH D
ARTEES	AA R T IY Z
ARTHOPEDIC	AA R T HH OW P T IH K
ARTHRO	AA R TH R OW
ARTI	AA R T IY
ARTILLERY	AA R T IH L ER IY
ARZAN	AA R Z AH N
ARZI	AA R Z IY
ARZOO	AA R Z UW
ARZUAN	AA R Z UW W AH N
AS	AE Z
AS(2)	EH Z
ASAAN	AE S EY AH N
ASAANI	AE S AH N IY
ASAL	AH Z AH L
ASALAM	AH Z AH L AE M
ASAR	AH Z ER
ASGHAR	AE Z AH R
ASHAAR	AE SH EY AH R
ASHAAT	AE SH AH T
ASHAB	AE SH AH B
ASHAD	AE SH AH D
ASHES	AE SH IH Z
ASHFAAQ	AE SH AH K
ASHIBAD	AE SH AH B AH D
ASHIYA	AH SH IY AY AH
ASHIYANA	AE SH IY AY AH N AH
ASHJAR	AE SH JH AA R
ASHNA	AE SH N AH
ASHOB	AH Z HH AA B
ASHRAF	AE SH R AH F
ASHRAM	AE SH R AE M
ASHREY	AE SH R IY
ASHRON	AE SH R AH N
ASHUR	AE SH ER
ASIA	EY ZH AH
ASIAN	EY ZH AH N
ASIAYI	EY S IY EY IY
ASJAD	AE Z AH D
ASLAH	AE Z L AH
ASLAHA	AE Z L AH HH AH
ASLAM	AH S L AE M
ASLOOB	AE Z L UW B
ASMAAN	AE Z M EY AH N
ASSALAMUALAIKUM	AE S AH L AE M Y UW AH L EY K AH M
ASSALAMUALAIKUM	AE S AH L AE M Y UW AH L EY K AH M
ASSASON	AE S AH S AH N
ASSI	AE S IY
ASSISTANT	AH S IH S T AH N T
ASWAD	AH Z W AA D
AT	AE T
ATA	AA T AH
ATALWI	AH T AE L W IY
ATAY	AE T EY IY
ATH	AE TH
ATHAARA	AE TH AH R AH
ATHAIIS	AE TH EY AH S
ATHAIS	AE TH EY AH S
ATHANVE	AE TH AH N V
ATHANWAY	AH TH AE N W EY IY
ATHARA	AE TH AH R AH
ATHASATH	AE TH AH S AH TH
ATHASI	AE TH AH S IY
ATHASSI	AH TH AE S IY
ATHATTAR	AH TH AE T AH R
ATHAWAN	AE TH AH AH N
ATHELETE	AE TH AH L IY T
ATHELETES	AE TH AH L IY T S
ATHELETICS	AH TH EH L AH T AH S Z
ATHHANVE	AE TH AH N V
ATHL	AE TH L
ATHON	AE TH AH N
ATISHBAZI	AH T IH SH B AH Z IY
ATISHZADGI	AE T AH SH Z AE JH IY
ATTH	AE T TH
ATTHAIIS	AE T TH EY AH S
ATTHARA	AE T TH AH R AH
ATTHATTAR	AE T TH AE T AH R
ATTHAWAN	AE T TH AH AH N
AUDIO	AA D IY OW
AUGUST	AA G AH S T
AUGUST(2)	AO G AH S T
AUHDA	AO D AH
AUJ	AO JH
AUJHAL	AO JH AH L
AUKHA	AO K AH
AULAAD	AO L AH D
AULTO	AO L T OW
AUN	AO N
AUQAAT	AO K AH T
AUQARIB	AO K AH R AH B
AUR	AO R
AURAT	AO R AH T
AURHE	AO R
AURHNA	AO R N AH
AURLUAAB	AO R L UW W AH B
AURN	AH ER N
AURUNG	AO R AH NG
AUSHRA	AO SH R AH
AUST	AO S T
AUSTRALVI	AO S T R AE L V IY
AUTHORITY	AH TH AO R AH T IY
AUZAAR	AO Z EY AH R
AVENUE	AE V AH N UW
AVISI	AE V AH S IY
AVM	AE V M
AWAAM	AO AH M
AWAAZ	AO AH Z
AWAKHIR	AO AE K AH R
AWAL	AO AH L
AWALEEN	AH W EY L AH N
AWARD	AH W AO R D
AWARENESS	AH W EH R N AH S
AWAZ	AO AH Z
AWAZEN	AO AH Z AH N
AWEZA	AO AH Z AH
AWRI	AO R IY
AWSAF	AO S AH F
AXEAN	AE K S AH N
AYA	EY AH
AYAAN	EY EY AH N
AYADA	EY AH D AH
AYADAT	EY AH D AH T
AYASHI	EY AH SH IY
AYE	AY
AYEIN	EY IY N
AYEN	AH Y EH N
AYES	AY Z
AYLOYT	EY L OY T
AYOOBI	EY AH B IY
AYTHRNIT	EY TH R N AH T
AYYAM	EY AY AH M
AZ	AE Z
AZAAB	AE Z AH B
AZAAD	AE Z AH D
AZAAZ	AE Z AH Z
AZADI	AE Z AH D IY
AZALA	AE Z AH L AH
AZAM	AE Z AH M
AZAN	EY Z AH N
AZDAWAJI	AE Z D AO AH JH IY
AZEEZ	EY Z IY Z
AZHAR	AH Z AA R
AZIZ	AH Z IY Z
AZLAA	AE Z L AH
B	B IY
B	B IY
BA	B AA
BAA	B AA
BAAB	B AA B
BAACH	B AA CH
BAAD	B AA D
BAAFTON	B AA F T AH N
BAAG	B AA G
BAAGH	B AA
BAAIS	B AA AH S
BAAM	B AA M
BAANJ	B AA N JH
BAAQI	B AA K IY
BAAR	B AA R
BAARAAN	B AA R EY AH N
BAARE	B AA R
BAAREY	B AA R IY
BAARISH	B AA R AH SH
BAARR	B AA R
BAASOL	B AA S AH L
BAAT	B AA T
BAAZ	B AA Z
BAAZO	B AA Z OW
BAAZUON	B AH Z UW W AH N
BACHA	B AE CH AH
BACHAO	B AE CH EY OW
BACHAYA	B AE CH EY AH
BACHAYEN	B AE CH EY AH N
BACHCHO	B AE CH OW
BACHE	B AE CH
BACHE(2)	B EY CH
BACHEN	B AE CH AH N
BACHI	B AE CH IY
BACHIYAN	B AH CH IY AY AH N
BACHIYON	B AH CH IY AY AH N
BACHNE	B AE K N
BACHNEY	B AE K N IY
BACHOLOR	B AE CH AH L AH R
BACHON	B AE CH AH N
BACHOO	B AE CH UW
BACHRE	B AE K R
BACHRI	B AE K R IY
BACHRON	B AE K R AH N
BACK	B AE K
BAD	B AE D
BADAL	B EY D AH L
BADAYE	B AE D EY
BADCHALNI	B AE D CH AE L N IY
BADGET	B AE D G EH T
BADHAANE	B AE D HH AH N
BADIKHLAQI	B AH D IH K L AH K IY
BADKHOO	B AE D K HH UW
BADLAY	B AE D L EY
BADLEIN	B AE D L IY N
BADLO	B AE D L OW
BADMAZGI	B AE D M AE Z IY
BADROOH	B AE D R UW
BADSHAH	B AE D SH AA
BADSOORAT	B AE D S AH R AH T
BADZAN	B AE D Z AH N
BAEES	B IY Z
BAGGAGE	B AE G IH JH
BAGGI	B AE JH IY
BAGHA	B AE AH
BAGHAAWAT	B AE AH W AH T
BAGHAIR	B AE G HH EH R
BAGHALGEER	B AE AH L JH IH R
BAGHAR	B AE AH R
BAGHAWAT	B AE AH AH T
BAGHBANI	B AE B AH N IY
BAGHEECHA	B AE IY CH AH
BAGHION	B AE IY AH N
BAGHIYANA	B AE IY AY AH N AH
BAGHOON	B AE UW N
BAGHOR	B AE AH R
BAGS	B AE G Z
BAHAAR	B AE HH EY AH R
BAHAO	B AE HH EY OW
BAHAR	B AE AH R
BA-HASIAT	B AA HH EY S IY AH T
BAHATTAR	B AH HH AE T AH R
BAHAYEN	B AE HH EY AH N
BAHEERA	B AE HH AH R AH
BAHEN	B AE AH N
BAHIR	B AH HH IH R
BAHON	B AE HH AH N
BAHU	B AE HH UW
BAICHNAY	B EY K N EY IY
BAIG	B EY G
BAIGAM	B EY G AH M
BAIIS	B EY IY Z
BAIL	B EY L
BAILCHA	B EY L CH AH
BAILS	B EY L Z
BAINGEN	B EY N JH AH N
BAIROONI	B AE AH R UW N IY
BAIS	B EY Z
BAISAAKHI	B EY S AA K IY
BAITHTAY	B EY TH T EY IY
BAIZE	B EY Z
BAIZVI	B EY Z IY
BAJA	B AA HH AA
BAJANWARI	B AH JH AE N W AH R IY
BAJAYE	B AE JH EY
BAJEN	B EY JH AH N
BAJRA	B AE JH R AH
BAJUZ	B AE JH AH Z
BAJWA	B AE JH W AH
BAKAYA	B AE K EY AH
BAKHABAR	B AE K AH B AH R
BAKHAIR	B AE K AH AH R
BAKHER	B AE K AH R
BAKHERNAY	B AE K AH R N EY IY
BAKHIDMAT	B AE K IH D M AH T
BAKHOOBI	B AE K AH B IY
BAKHSH	B AE K
BAKHSHAY	B AE K EY IY
BAKHSHE	B AE K
BAKHSHEEN	B AE K IY AH N
BAKHSHI	B AE K IY
BAKHSHISH	B AE K AH SH
BAKHSHO	B AE K OW
BAKIR	B AE K AH R
BALDEATI	B AE L D AH T IY
BALGHAM	B AE L AH M
BALIGH	B AE L IY
BALIGHAAN	B AH L AY EY AH N
BALIGHON	B AE L AY AH N
BALKAY	B AE L K EY IY
BALKE	B EY L K
BALKEY	B IY AH L K IY
BALOCHI	B AE L AH CH IY
BALOCHON	B AE L AH CH AH N
BALOONGRE	B AH L UW N G AH R
BALOUCH	B AH L AW CH
BAN	B AE N
BANA	B AE N AH
BANAE	B AE N IY
BANAFSHI	B AH N AE F IY
BANAI	B AE N EY
BANANA	B AH N AE N AH
BANANE	B AH N EY N
BANAYA	B AE N EY AH
BANAYE	B AE N EY
BANAYEN	B AE N AH Y EH N
BANAYI	B AE N EY IY
BAND	B AE N D
BANDHEN	B AE N D HH EH N
BANDNE	B AE N D N
BANDOK	B AE N D AH K
BANDOOQ	B AE N D AH K
BANE	B EY N
BANEIN	B EY N IH N
BANEN	B EY N AH N
BANG	B AE NG
BANGALI	B AE N G AH L IY
BANGLA	B AE N G L AH
BANGLE	B AE NG G AH L
BANK	B AE NG K
BANO	B AE N OW
BANORI	B AE N AH R IY
BANSURI	B AE N S AH R IY
BAOHAR	B EY AH AH R
BAPHRAY	B AE F R EY IY
BAQAYA	B AE K EY AH
BAQIYA	B AH K IY AY AH
BAQOL	B AE K AH L
BAR	B AA R
BARA	B AA R AH
BARABAR	B EH R AH B AA R
BARAFBARI	B AH R AE F B AH R IY
BARAN	B AA R AA N
BARAS	B AE R AH Z
BARASNE	B AE R AH Z N
BARDAAR	B AA R D EY AH R
BARDASHT	B AA R D AH SH T
BARE	B EH R
BAREAZAM	B AH R IY Z AH M
BAREAZEEM	B AE R AH Z IY M
BAREESH	B AH R IY SH
BARH	B AA R
BARHA	B AA R AH
BARHAEIN	B AA R IY AH N
BARHAUN	B AA R AH N
BARHAWA	B AA R AH AH
BARHAYA	B AA R EY AH
BARHAYI	B AA R EY IY
BARHEN	B AA R HH EH N
BARHOTRI	B AH R AA T R IY
BARI	B AA R IY
BARKHILAF	B AA R K AH L AH F
BARON	B AE R AH N
BARON(2)	B EH R AH N
BARONQ	B AE R AH N K
BARORI	B AE R AH R IY
BAROZ	B AE R AH Z
BARQARAR	B AA R K AH R AH R
BARRA	B AA R AH
BARRAGE	B ER AA ZH
BARRI	B AE R IY
BARSARE	B AA R S AH R
BARSATA	B AA R S AH T AH
BARSON	B AA R S AH N
BARTAN	B AA R T AE N
BARTANWI	B AA R T AE N W IY
BARTFI	B AA R T IY
BARWAN	B AA R W AA N
BARWE	B AA R W
BARYAAT	B AE R AY AH T
BAS	B AE Z
BASA	B AA S AH
BASAR	B EY S ER
BASATH	B AE S AH TH
BASAYEN	B AE S EY AH N
BASEMENT	B EY S M AH N T
BASEN	B EY S AH N
BASHAASH	B AE SH AH SH
BASHAOOR	B AH SH EY OW AH R
BASHEER	B AH SH IH R
BASHINDON	B AH SH IH N D AH N
BASHMOOL	B AE SH M UW L
BASIC	B EY S IH K
BASIYAR	B EY S IY IY ER
BASSON	B EY S AO N
BATA	B AE T AH
BATAATEY	B AE T AH EY T IY
BATADREEJ	B AE T AH D R IY JH
BATAEIN	B AE T IY AH N
BATAIYE	B AE T EY AY
BATAKHON	B AH T AE K AH N
BATAO	B AE T EY OW
BATAOUN	B AE T EY AW N
BATATA	B AE T AH T AH
BATATI	B AE T AH T IY
BATAUN	B AE T AH N
BATAYA	B AE T EY AH
BATAYEN	B AE T AH Y EH N
BATEES	B EY T IY Z
BATHEIN	B EY DH IH N
BATHNE	B AE TH N
BATHOO	B AE TH UW
BATORTA	B AH T AO R T AH
BATTIIS	B AE T IY IY Z
BAUNDRY	B AO N D R IY
BAWAA	B AO AH
BAWAJOOD	B AO AH JH UW D
BAWAN	B AO AH N
BAWAQTE	B AO AH K T
BAWARCHI	B AO AA R K IY
BAYAAN	B EY EY AH N
BAYAN	B EY AH N
BAYANA	B EY AH N AH
BAYEIN	B EY IY N
BAYNH	B EY N
BAYYAN	B EY AY AH N
BAZAHIR	B AE Z AH HH AH R
BAZEECHA	B EY Z IY CH AH
BAZIYAB	B EY Z IY AY AH B
BAZOQ	B AE Z AH K
BAZOR	B EY Z AH R
BBUREAUCRACY	B Y UH R IY AH K R AH S IY
BCHU	B CH UW
BDHALI	B D HH AE L IY
BDLAH	B D L AE
BE	B IY
BEASAR	B AH EY Z AH R
BEBAAQ	B AH B AA K
BECAUSE	B IH K AO Z
BECAUSE(2)	B IH K AH Z
BECAUSE(3)	B IH K AA Z
BECHARE	B AH CH AE R
BECHEN	B EH CH AH N
BECHENI	B AH CH EH N IY
BECHEY	B EH CH IY
BED	B EH D
BEDAAR	B AH D EY AH R
BEDAARI	B AH D AA R IY
BEDROOM	B EH D R UW M
BEECH	B IY CH
BEECHO	B IH EH K OW
BEEF	B IY F
BEEJ	B AH EH JH
BEEJON	B AH EH JH AH N
BEEKH	B AH EH K
BEES	B IY Z
BEESWIEN	B AH EH S W IY AH N
BEEWIYON	B IH Y UW IY IY AO N
BEFORE	B IH F AO R
BEFORE(2)	B IY F AO R
BEGUM	B IH G AH M
BEHAD	B AH HH AE D
BEHAJ	B AH HH AE JH
BEHAN	B EH HH AH N
BEHAR	B EH HH ER
BEHAS	B AH HH AE Z
BEHASTA	B AH HH AE S T AH
BEHBOOD	B IH HH B UW D
BEHNOI	B IH HH N OY
BEHOODA	B AH HH UW D AH
BEHOSH	B AH HH AA SH
BEHSE	B IH HH S IY
BEHSON	B IH HH S AA N
BEHT	B EH T
BEHTAR	B EH T AH R
BEHTAREEN	B IH HH T AE R IY AH N
BEHTARI	B IH HH T AE R IY
BEIZZATI	B AH IH Z AH T IY
BEJE	B AH JH IY
BEJU	B AH JH UW
BEKASON	B AH K AE S AH N
BELCHE	B IH L CH IY
BELON	B EH L AO N
BELT	B EH L T
BEMAARI	B AH M AA R IY
BENAAT	B AH N AA T
BENCH	B EH N CH
BEOPAR	B AH OW P AH R
BERA	B EH R AH
BEREY	B IY R IY
BERRIYAN	B IH R AY AY AH N
BESAN	B Z AE N
BESHTAR	B EH SH T AH R
BEST	B EH S T
BESUD	B AH S AH D
BETH	B EH TH
BETHA	B AH TH AA
BETHAK	B AH TH AE K
BETHE	B AH DH IY
BETHEIN	B AH TH IY N
BETHI	B AH TH IY
BETHO	B AH TH OW
BETI	B AH T IY
BEURO	B AH Y UH R OW
BEWAH	B AH W AA
BEWAQAT	B AH W AE K AH T
BEWAQOOF	B IH W AH K UW F
BEY	B EY
BEYALIIS	B IY IY AH L IY IY Z
BEYANVE	B AH Y AE N V
BEYOGAN	B AH Y OW G AH N
BEZAAR	B AH Z EY AH R
BFT	B IY EH F T
BHAAG	B HH AA G
BHAAL	B HH EY AH L
BHAARI	B HH AA R IY
BHABHI	B HH AE B HH IY
BHADDI	B HH AE D IY
BHAEN	B HH EY AH N
BHAGDAR	B HH AE G D AH R
BHAGORON	B HH AE G AH R AH N
BHAI	B HH EY
BHAID	B HH EY D
BHAIJ	B HH EY JH
BHAIYON	B HH EY AY AH N
BHAJJAN	B HH AE JH AH N
BHALA	B HH AE L AH
BHANGRA	B AA NG G R AH
BHANGRE	B HH AE N G AH R
BHANJE	B HH AE N JH
BHANON	B HH AE N AH N
BHANP	B HH AE N P
BHAO	B HH EY OW
BHAR	B HH AA R
BHARAK	B HH AE R AH K
BHARAS	B HH AE R AH Z
BHARAT	B HH AE R AH T
BHARE	B HH AE R
BHARI	B HH AE R IY
BHAROSA	B HH AE R AH S AH
BHARTA	B HH AA R T AH
BHARTI	B HH AA R T IY
BHASE	B HH EY Z
BHASHA	B HH AE SH AH
BHASM	B HH AE Z AH M
BHAWAJ	B HH AO AH JH
BHAYANAK	B HH EY AH N AH K
BHEEGY	B HH IY JH IY
BHEEL	B HH IY L
BHEEM	B HH IY M
BHEJ	B HH EH JH
BHEJA	B HH EH JH AH
BHEJE	B HH IY JH
BHEJEN	B HH IY JH AH N
BHEJI	B HH EH JH IY
BHEJNAY	B HH EH JH N EY IY
BHELDAR	B HH EH L D AH R
BHENGA	B HH EH N G AH
BHENS	B HH EH N Z
BHENT	B HH EH N T
BHENTEN	B HH EH N T AH N
BHERAIN	B HH AH R EY N
BHERHAYE	B HH EH R EY
BHERHON	B HH EH R AH N
BHERIYA	B HH IY R IY AY AH
BHERIYE	B HH IY R IY AY
BHERVI	B HH AH R V IY
BHETUN	B HH EH T AH N
BHI	B HH IY
BHIGO	B HH IH G OW
BHIGOYEN	B HH IH G OY AH N
BHIJWA	B HH IH JH W AH
BHIKAR	B HH AY K AH R
BHINA	B HH IH N AH
BHINDI	B HH IH N D IY
BHINSIN	B HH IH N S AH N
BHIRH	B HH IH R
BHIRON	B HH IH R AH N
BHJWAYIN	B HH JH W EY AH N
BHOJHPOORI	B HH AA JH HH P AH R IY
BHOLA	B HH AA L AH
BHONCHAL	B HH AA N CH AH L
BHONDI	B HH AA N D IY
BHOOL	B HH UW L
BHOOLEN	B HH UW L AH N
BHOOLIYE	B HH UW L IY AY
BHOOLNA	B HH UW L N AH
BHOOLO	B HH UW L OW
BHOOMI	B HH UW M IY
BHOOND	B HH UW N D
BHOORA	B HH UH R AH
BHOORE	B HH UH R
BHOOSA	B HH UW S AH
BHOOSE	B HH UW Z
BHOOT	B HH UW T
BHOT	B HH AA T
BHRANI	B HH R AE N IY
BHSIN	B HH S IH N
BHUGTI	B HH AH G T IY
BHUJHAI	B HH AH JH HH EY
BHUJNE	B HH AH JH N
BHULAYA	B HH Y UW L EY AH
BHURBHURI	B HH AH R B HH Y AH R IY
BHUTTO	B UW T OW
BIALLAH	B AY AE L AH
BIASSI	B AY AE S IY
BICH	B IH CH
BICHA	B AY CH AA
BICHANE	B AY CH EY N
BICHAR	B AY CH AA R
BICHAYE	B AY CH EY
BICHE	B AY CH IY
BICHI	B AY CH IY
BICHONA	B AY CH OW N AH
BIG	B IH G
BIGARH	B AY G AA R
BIGARNE	B AY G AA R N
BIGGER	B IH G ER
BIGREN	B IH G R AH N
BIJLEE	B IH JH L IY IY
BIKE	B AY K
BIKHRE	B AY K R
BIKHRI	B AY K R IY
BIL	B IH L
BILA	B IY L AH
BILKHUSHOOS	B AY L K AH SH UW Z
BILKUL	B AY L K AH L
BILLI	B AY L IY
BILLION	B IH L Y AH N
BILLON	B IH L AH N
BILOWER	B AY L OW ER
BINAULA	B AY N AO L AH
BIOLOGICAL	B AY AH L AA JH IH K AH L
BIOS	B AY OW S
BIRD	B ER D
BISTAR	B AY S T AA R
BIT	B IH T
BITCHRHA	B AY CH R AA
BITHA	B AY TH AA
BIWI	B AY W IY
BIYANWE	B AY Y AE N W
BL	B IY L
BLA	B L AA
BLAKHOF	B L AE K AH F
BLEECH	B L IY CH
BLGRAMI	B L G R AE M IY
BLOCK	B L AA K
BLOCKING	B L AA K IH NG
BLOOGHAT	B L UW AH T
BLOOS	B L UW Z
BOARD	B AO R D
BOARDER	B AO R D ER
BOBBY	B AA B IY
BOCHAR	B AA CH AH R
BODY	B AA D IY
BOGUS	B OW G AH S
BOHAT	B AA HH AH T
BOHRAAN	B AA R EY AH N
BOI	B OY
BOKLAHAT	B AA K L AH HH AH T
BOL	B AA L
BOLA	B OW L AH
BOLAN	B OW L AH N
BOLE	B OW L
BOLEIN	B OW L IY N
BOLI	B OW L IY
BOLNAY	B OW L N EY IY
BOLO	B OW L OW
BOLUN	B AA L AH N
BOMB	B AA M
BOMB(2)	B AO M
BONO	B OW N OW
BONUS	B OW N AH S
BOO	B UW
BOOJH	B UW JH
BOOJHO	B UW JH HH OW
BOOM	B UW M
BOORHA	B UH R AH
BOORHAY	B UH R HH EY
BOORHI	B UH R IY
BORHOON	B AH R UW N
BORIYAT	B AH R IY AY AH T
BOS	B AA S
BOSAN	B OW Z AH N
BOSNIYAI	B AA Z N IY AY EY
BOTH	B OW TH
BOWING	B OW IH NG
BOWING(2)	B AW IH NG
BOWLER	B OW L ER
BOWLERON	B OW L ER AO N
BOWLING	B OW L IH NG
BOX	B AA K S
BOY	B OY
BOYA	B OY AH
BOYE	B OY
BOYEN	B OY AH N
BOYS	B OY Z
BRABAR	B R EY B AH R
BRAHMIN	B R AA M IH N
BRAVO	B R AA V OW
BREATHLIZER	B R IY TH L AY Z AH R
BRIDGE	B R IH JH
BRIEFING	B R IY F IH NG
BRIGADE	B R AH G EY D
BRIGADE(2)	B R IH G EY D
BRIGADIER	B R IH G AH D IH R
BROAD	B R AO D
BROCCOLI	B R AA K AH L IY
BROCCOLI(2)	B R AA K L IY
BROWSER	B R AW Z ER
BRUSH	B R AH SH
BUDAKTA	B Y UW D AE K T AH
BUDDHI	B AH D HH IY
BUDH	B AH D
BUDHA	B AH D HH AH
BUDHE	B AH D HH
BUDHU	B AH D HH UW
BUFFER	B AH F ER
BUGAT	B Y UW G AH T
BUGHDADI	B AH D AH D IY
BUGHZ	B AH Z
BUHAT	B AH HH AH T
BUILDER	B IH L D ER
BUILDERS	B IH L D ER Z
BUILDING	B IH L D IH NG
BUJEY	B Y UW JH IY
BUJHANE	B AH JH HH EY N
BUJHI	B AH JH HH IY
BUKHARI	B AH K AH R IY
BULAA	B Y UW L AH
BULAA	B Y UW L AH
BULAND	B Y UW L AH N D
BULBUL	B UH L B AH L
BULDOZE	B UH L D OW Z
BULLDOZER	B UH L D OW Z ER
BULLDOZERON	B UH L D OW Z ER AO N
BUNUN	B Y UW N AH N
BUNYADI	B Y UW N AY AH D IY
BUQA	B AH K AH
BUREAUCRATS	B Y UH R AH K R AE T S
BUREAUCRATS(2)	B Y UH R OW K R AE T S
BURHAAPE	B AH R AH P
BURHAN	B AH R AH N
BURHIYA	B AH R IY AY AH
BURI	B UH R IY
BUS	B AH S
BUSH	B UH SH
BUSINESS	B IH Z N AH S
BUSINESS(2)	B IH Z N IH S
BUSS	B AH S
BUT	B AH T
BUZDIL	B AH Z D AH L
BUZURAG	B Y UW Z AH R AH G
BUZURGWAAR	B Y UW Z AH R G W EY AH R
BY	B AY
BYALIIS	B AY AH L IY IY Z
BYASSI	B AY AE S IY
C	S IY
C	S IY
CAFÃ©	K AE F
CAHND	K AE N D
CAHVA	K AE V AH
CALCIUM	K AE L S IY AH M
CALIING	K AE L AY AH NG
CALL	K AO L
CALLED	K AO L D
CALLING	K AO L IH NG
CALLS	K AO L Z
CAME	K EY M
CAMP	K AE M P
CAN	K AE N
CAN(2)	K AH N
CANADIAN	K AH N EY D IY AH N
CANNOT	K AE N AA T
CANNOT(2)	K AH N AA T
CARBON	K AA R B AH N
CARD	K AA R D
CAREER	K ER IH R
CAREFUL	K EH R F AH L
CAREFULLY	K EH R F AH L IY
CARIO	K AE R IY OW
CASE	K EY S
CASES	K EY S AH Z
CASES(2)	K EY S IH Z
CASON	K AE S AH N
CATARACT	K AE T ER AE K T
CATCH	K AE CH
CELL	S EH L
CELLULITE	S EH L AH L AY T
CENTER	S EH N T ER
CENTER(2)	S EH N ER
CENTRE	S EH N T ER
CENTURIYAN	S EH N T Y AH R IY AY AH N
CENTURY	S EH N CH ER IY
CH	S IY
CHAABI	CH AA B IY
CHAAQ	CH AA K
CHAAQOO	CH AA K UW
CHAAR	CH EY AH R
CHAASHNI	CH AA SH N IY
CHABA	CH AE B AH
CHABBIS	CH AE B AH S
CHABEES	CH EY B IY Z
CHABRI	CH AE B R IY
CHACH	CH AE CH
CHACHA	CH AE CH AH
CHACHAK	CH AE CH AH K
CHACHAR	CH AE CH AH R
CHACHOO	CH AE CH UW
CHAD	CH AE D
CHADDA	CH AE D AH
CHADDAR	CH AE D AH R
CHAEANVE	CH IY AH N V
CHAEYALIS	CH IY AY AH L AH S
CHAHARAM	CH AE HH AH R AH M
CHAHE	CH AE HH
CHAHEN	CH AE AH N
CHAHIYE	CH AE HH IY AY
CHAHTE	CH AE T
CHAHTI	CH AE T IY
CHAHUN	CH AE HH AH N
CHAI	CH AY
CHAICHEN	CH EY CH AH N
CHAIR	CH EH R
CHAIRAG	CH AE AH R AH G
CHAIRMAN	CH EH R M AH N
CHAIYAN	CH EY AY AH N
CHAKA	CH AE K AH
CHAKANDAR	CH AH K AE N D AH R
CHAKHEN	CH AE K AH N
CHAKO	CH AE K OW
CHAL	CH AE L
CHALA	CH AE L AH
CHALAY	CH AE L EY IY
CHALAYE	CH AE L EY
CHALAYEN	CH AE L EY AH N
CHALE	CH EY L
CHALEES	CH EY L IY Z
CHALEIN	CH EY L IY N
CHALEIYE	CH EY L IY AY
CHALEY	CH EY L IY
CHALGOZAY	CH AE L G AA Z EY IY
CHALIS	CH EY L AH S
CHALK	CH AA K
CHALK(2)	CH AO K
CHALLAN	CH AE L AH N
CHALLENGE	CH AE L AH N JH
CHALLENGES	CH AE L AH N JH IH Z
CHALNE	CH AE L N
CHALO	CH AE L OW
CHALTA	CH AE L T AH
CHALTI	CH AE L T IY
CHALUN	CH AE L AH N
CHAMACH	CH AE M AH CH
CHAMAN	CH EY M AH N
CHAMCHA	CH AE M CH AH
CHAMCHAY	CH AE M CH EY IY
CHAMP	CH AE M P
CHAMPION	CH AE M P IY AH N
CHAMPIONS	CH AE M P IY AH N Z
CHAMRA	CH AE M R AH
CHAMRRE	CH AE M R
CHAN	CH AE N
CHAND	CH AE N D
CHANGA	CH AE N G AH
CHANGESMAIN	CH EY N JH IH Z M EY N
CHANGEZIASSEMBLY	CH AE N JH IY Z IY AE S EH M L IY
CHANNEL	CH AE N AH L
CHANT	CH AE N T
CHAONI	CH EY AH N IY
CHAONIA	CH EY OW N Y AH
CHAPPAN	CH AE P AE N
CHAPWAYIN	CH AE P W EY IH N
CHAR	CH AA R
CHARAGHA	CH AE R AH AH
CHARANEY	CH AH R EY N IY
CHARH	CH AA R
CHARHA	CH AA R AH
CHARHAO	CH AA R EY OW
CHARI	CH AE R IY
CHARITY	CH EH R IH T IY
CHASE	CH EY S
CHASHM	CH AE SH M
CHASING	CH EY S IH NG
CHASSIS	CH AE S IY
CHATIIS	CH AE T IY IY Z
CHATTIS	CH AE T IY Z
CHAUBIIS	CH AO B IY AH S
CHAUBIS	CH AO B AH S
CHAUDA	CH AO D AH
CHAUDHRAIN	CH AO D HH R EY N
CHAUDHRY	CH AO D R IY
CHAUHATTAR	CH AH HH AE T AH R
CHAUHATTER	CH AH HH AE T AH R
CHAUNSATH	CH AO N S AH TH
CHAUNTEES	CH AO N T IY Z
CHAUNTIIS	CH AO N T IY AH S
CHAUNTIS	CH AO N T AH S
CHAURANVE	CH AO R AH N V
CHAURASSI	CH AH R AE S IY
CHAWAL	CH AO AH L
CHAWALEES	CH AO AH L IY Z
CHAWALIIS	CH AO AH L IY IY Z
CHAWALIS	CH AO AH L IY Z
CHAWWAN	CH AO W AA N
CHAYA	CH EY AH
CHAYE	CH EY
CHECK	CH EH K
CHED	CH EH D
CHEEKH	CH IY K
CHEEKHAIN	CH IY K EY N
CHEEKHNAY	CH IY K N EY IY
CHEEL	CH IY L
CHEELNE	CH IY L N
CHEEMA	CH IY M AH
CHEEN	CH IY AH N
CHEENI	CH IY N IY
CHEENKE	CH IY NG K
CHEER	CH IH R
CHEERH	CH IH R
CHEET	CH IY T
CHEETHREY	CH IY TH R IY
CHEEZ	CH IY Z
CHEEZEN	CH IY Z AH N
CHEHARON	CH EH HH AH R AH N
CHEHCHAHAHAT	CH AH CH AE HH AH HH AH T
CHEHLUM	CH EH L AH M
CHER	SH EH R
CHEST	CH EH S T
CHEWING	CH UW IH NG
CHEY	CH IY IY
CHHABBIS	CH HH AE B AH S
CHHABIIS	CH HH EY B IY AH S
CHHAE	CH HH IY
CHHAEHATTAR	CH HH IY HH AE T AH R
CHHAEYALIIS	CH HH IY AY EY L IY AH S
CHHAEYASATH	CH HH IY AY AH S AH TH
CHHAEYASSI	CH HH IY AY AE S IY
CHHAIRNAY	CH HH AE AH R N EY IY
CHHAPA	CH HH AE P AH
CHHAPPAN	CH HH AE P AH N
CHHARRYAN	CH HH AE R AY AH N
CHHATEES	CH HH EY T IY Z
CHHEHATAR	CH HH EH EY T AH R
CHHEYANWAY	CH HH EY AE N W EY IY
CHHOYIN	CH HH OY AH N
CHIEF	CH IY F
CHIEFS	CH IY F S
CHIHAL	CH IH AH L
CHILCHELATI	CH IH L CH EH L AH T IY
CHILD	CH AY L D
CHILH	CH IH L
CHILKAY	CH IH L K EY IY
CHILKHA	CH IH L K AH
CHIMTE	CH IH M T
CHINA	CH AY N AH
CHINEYOTI	CH AH N EY AH T IY
CHIRAK	CH IH R AH K
CHIRCHIRA	CH AH R CH AH R AH
CHIRCHIRE	CH AH R CH AY R
CHIRH	CH IH R
CHIRIYA	CH AH R IY AY AH
CHIRNE	CH AH R N
CHIRRIYON	CH AH R IY AY AH N
CHISHTI	CH IH SH T IY
CHOBAND	CH AA B AH N D
CHOBEES	CH OW B IY Z
CHODA	CH OW D AH
CHODAH	CH AA D AH
CHODEN	CH OW D AH N
CHOHAAN	CH AA HH EY AH N
CHOHE	CH AA HH
CHOICE	CH OY S
CHOKHAT	CH AA K AH T
CHOLE	CH OW L
CHOLESTEROL	K AH L EH S T ER AO L
CHOLESTEROL(2)	K AH L EH S T ER AH L
CHOLIKA	CH AA L AH K AH
CHON	CH AA N
CHONCHLE	CH AO NG K L
CHOND	CH AA N D
CHONGI	CH AA N JH IY
CHONKA	CH AO NG K AH
CHONSATH	CH AA N S AH TH
CHONTEES	CH AA N T IY Z
CHOOHON	CH UW HH AH N
CHOOLHE	CH UW L HH
CHOOM	CH UW M
CHOONKE	CH UW NG K
CHOOSNE	CH UW Z N
CHOR	CH AO R
CHORA	CH AO R AH
CHORANGI	CH AH R AE N JH IY
CHOREOGRAPHER	K AO R IY AA G R AH F ER
CHORI	CH AO R IY
CHORIYAN	CH AH R IY AY AH N
CHORNE	CH AO R N
CHORON	CH AO R AH N
CHORR	CH AO R
CHORRU	CH AO R UW
CHOTA	CH OW T AH
CHOTAY	CH AA T EY IY
CHOTE	CH OW T
CHOTHA	CH AA TH AH
CHOTHE	CH OW DH
CHOTHI	CH AA TH IY
CHOTI	CH OW T IY
CHOUP	CH UW P
CHOZE	CH OW Z
CHOZON	CH AA Z AH N
CHROMOSOME	K R OW M AH S OW M
CHROMOSOME(2)	K R OW M AH Z OW M
CHUA	K UW AH
CHUA(2)	K W AA
CHUBH	CH AH B
CHUBHNE	CH AH B HH N
CHUGHLI	CH AH L IY
CHUGHNI	CH AH N IY
CHUGHTAI	CH AH T EY
CHUGNE	CH AH N
CHUHAARE	CH AH HH AH R
CHUIYA	CH UW AY AH
CHUKA	CH UW K AH
CHUKE	CH UW K
CHUM	CH AH M
CHUNANCHE	CH UW N AH NG K
CHUNDHIYA	CH AH N D HH IY AY AH
CHUNGAL	CH AH N G AH L
CHUP	CH AH P
CHÙUP	CH AH P
CHUPA	CH UW P AH
CHURAIL	CH AH R EY L
CHURANE	CH AH R EY N
CHURCH	CH ER CH
CHURI	CH UH R IY
CHURRA	CH AH R AH
CHURRI	CH AH R IY
CHUST	CH AH S T
CHUTI	CH UW T IY
CHUTIYAN	CH UW T IY AY AH N
CHUTTI	CH AH T IY
CHUYE	CH UW W AY
CHYASEEVEIN	CH AY EY S AH V EY N
CIGGERETTE	S IH JH AH R EH T
CINEMA	S IH N AH M AH
CITY	S IH T IY
CIVIC	S IH V IH K
CIVIL	S IH V AH L
CIVILIAN	S AH V IH L Y AH N
CLAIM	K L EY M
CLASHAN	K L AE SH AH N
CLASSES	K L AE S AH Z
CLASSES(2)	K L AE S IH Z
CLEAR	K L IH R
CLEARANCE	K L IH R AH N S
CLEARING	K L IH R IH NG
CLONING	K L OW N IH NG
CLOSE	K L OW S
CLOSE(2)	K L OW Z
CNIC	K N IH K
CNIC	K N IH K
COACH	K OW CH
COACHING	K OW CH IH NG
COACHON	K OW CH AO N
CODE	K OW D
COLLEGE	K AA L IH JH
COLLEGES	K AA L IH JH IH Z
COLLEGON	K AA L EH G AH N
COLON	K OW L AH N
COLONY	K AA L AH N IY
COMBINATION	K AA M B AH N EY SH AH N
COME	K AH M
COMEDY	K AA M AH D IY
COMES	K AH M Z
COMISSION	K OW M IH SH AH N
COMITEE	K OW M AY T IY
COMMISSIONAIRE	K AH M IH SH AH N AH AY ER
COMMUNIST	K AA M Y AH N AH S T
COMMUNITY	K AH M Y UW N AH T IY
COMMUNITY(2)	K AH M Y UW N IH T IY
COMODORE	K AH M AA D AH R
COMPANION	K AH M P AE N Y AH N
COMPANY	K AH M P AH N IY
COMPARING	K AH M P EH R IH NG
COMPLAIN	K AH M P L EY N
COMPUTERIZED	K AH M P Y UW T ER AY Z D
CONFERECON	K AA N F EH R AH K AH N
CONFERENCE	K AA N F ER AH N S
CONFERENCE(2)	K AA N F R AH N S
CONFIRM	K AH N F ER M
CONFUSE	K AH N F Y UW Z
CONFUSED	K AH N F Y UW Z D
CONFUSING	K AH N F Y UW Z IH NG
CONFUSION	K AH N F Y UW ZH AH N
CONGRESS	K AA NG G R AH S
CONSOCIOUM	K AA N S OW S IY AW M
CONTACT	K AA N T AE K T
CONTINUE	K AH N T IH N Y UW
CONTINUES	K AH N T IH N Y UW Z
CONTRACT	K AA N T R AE K T
CONTRACT(2)	K AH N T R AE K T
CONTROL	K AH N T R OW L
CONVENTION	K AH N V EH N SH AH N
CONVINCE	K AH N V IH N S
CONVOCATION	K AA N V AH K EY SH AH N
CO-ORDINATOR	K OW AO R D AH N AH T ER
CO-ORPORATION	K OW AO R P AH R EY SH AH N
COROLLA	K ER AA L AH
CORRECTLY	K ER EH K T L IY
COSMOS	K AA Z M OW S
COUCH	K AW CH
COUCHWAN	K AW CH W AA N
COUNCELATE	K OW AH N S AH L EY T
COUNCELLER	K OW AH N S EH L ER
COUNCIL	K AW N S AH L
COUNTER	K AW N T ER
COUNTING	K AW N T IH NG
COUNTY	K AW N T IY
COUNTY(2)	K AW N IY
COURE	K OW Y AH R
COURIER	K ER IY ER
COURSE	K AO R S
COVERAGE	K AH V ER AH JH
COVERAGE(2)	K AH V ER IH JH
COVERAGE(3)	K AH V R IH JH
CRASH	K R AE SH
CRORE	K R AO R
CRUSHING	K R AH SH IH NG
CULTURE	K AH L CH ER
CULTUS	K AH L T AH S
CUNCIL	K AH N S AH L
CUP	K AH P
CURFEW	K ER F Y UW
CUZ	K AH Z
CYBERPEDIA	S IH B AH R P IY D IY AH
CYCLE	S AY K AH L
D	D IY
D	D IY
DAAGH	D AA
DAAGHNE	D AA N
DAAKHLON	D AA K L AH N
DAAKHUON	D AA K Y UW AH N
DAAL	D EY AH L
DAALEN	D AA L AH N
DAALNAY	D AA L N EY IY
DAALNE	D AA L N
DAAM	D AA M
DAAR	D EY AH R
DABAIYE	D AE B EY AY
DABAO	D AE B EY OW
DABAYA	D AE B EY AH
DABAYE	D AE B EY
DABAYIYE	D AH B EY IY AY
DABB	D AE B
DABBA	D AE B AH
DABEEZ	D EY B IY Z
DABO	D AE B OW
DABOCH	D AE B AH CH
DACHKA	D AE CH AH
DADA	D AA D AA
DADI	D AE D IY
DAED	D EY D
DAFA	D AE F AH
DAFAN	D EY F AH N
DAFFA	D AE F AH
DAFTAR	D AE F T AH R
DAGAR	D AE G ER
DAGHA	D AE AH
DAGHDAR	D AE D AH R
DAGHE	D AE
DAHA	D AE HH AH
DAHAI	D AE HH EY
DAHI	D AE HH IY
DAHINDGAAN	D AH HH IH N JH EY AH N
DAIHATSU	D AY HH AE T S UW
DAILY	D EY L IY
DAJ	D AE JH
DAKHAL	D AE K AH L
DAKHIL	D AE K AH L
DAKHLA	D AE K L AH
DAKHLON	D AE K L AH N
DAL	D AE L
DALNE	D AE L N
DALTE	D AE L T
DALUN	D AE L AH N
DAM	D AE M
DANCE	D AE N S
DANG	D AE NG
DANISH	D EY N IH SH
DANISHWER	D AH N IH SH W AH R
DANSHMNDANH	D AE N SH M N D AH N
DANSHO	D AE N SH OW
DAO	D AW
DAR	D AA R
DARAAZ	D AE R AH Z
DARAKHSHAN	D AH R AE K AH N
DARAKHT	D AE R AH K T
DARARE	D AE R AH R
DARD	D AA R D
DAREECHE	D AH R IY CH
DAREGH	D AE R
DARH	D AA R
DARI	D AE R IY
DARJ	D AA R JH
DARJAN	D AA R JH AH N
DARJE	D AA R JH
DARJON	D AA R JH AH N
DARKHOR	D AA R K AH R
DARKHWAST	D AA R K W AH S T
DARMIYAAN	D AA R M IY AY EY AH N
DARMIYAN	D AA R M IY AY AH N
DARMYANA	D AA R M AY AH N AH
DAROMADAR	D AH R AA M AH D AH R
DARON	D AE R AH N
DARRI	D AE R IY
DARS	D AA R Z
DARSGAH	D AA R S G AH
DARSGAHON	D AA R S G AH HH AH N
DAR-UL-KHILAFA	D AA R AH L K HH IH L AH F AH
DARYAFT	D AE R AY AH F T
DARYAON	D EH R IY AH AO N
DAS	D AE S
DAS(2)	D AA S
DASH	D AE SH
DASHT	D AE SH T
DASS	D AE S
DASTAAN	D AE S T EY AH N
DASTAWIZAAT	D AE S T AO AH Z AH T
DASTAWIZI	D AE S T AO AH Z IY
DASWEIN	D AE S W IY N
DATE	D EY T
DAUD	D AO D
DAUDI	D AO D IY
DAULAT	D AO L AH T
DAUNGA	D AO N G AH
DAUR	D AO R
DAURAA	D AO R AH
DAVID	D EY V IH D
DAWA	D AO AH
DAWAON	D AO EY AH N
DAWON	D AO AH N
DAWOOD	D AO UW D
DAY	D EY
DAYANATDAR	D EY AH N AE T D AH R
DAYEN	D EY AH N
DBOYIN	D B OY AH N
DDAAL	D EY AH L
DDAL	D AE L
DDOSRE	D AA Z AH R
DE	D IY
DE(2)	D EY
DE(3)	D AH
DEAD	D EH D
DEAL	D IY L
DEATH	D EH TH
DEBACHA	D AH B AE CH AH
DEBACHAY	D AH B AE CH EY IY
DEBATE	D AH B EY T
DEBIT	D EH B IH T
DECEMBER	D IH S EH M B ER
DECLERATION	D IH K L AH R EY SH AH N
DEEGAR	D IY IY G AH R
DEEN	D IY N
DEEWAAR	D IY Y UW EY AH R
DEFENCE	D IH F EH N S
DEGA	D AH G AA
DEGCHI	D IH G CH IY
DEGREE	D IH G R IY
DEHAAN	D EH HH AA N
DEHAL	D EH AH L
DEHATION	D IY HH EY SH AH N
DEHELVI	D AH HH EH L V IY
DEHLA	D IH HH L AA
DEHLI	D IH HH L IY
DEHSHAT	D IH HH SH AE T
DEIN	D IY IH N
DEKH	D EH K
DEKHA	D IH K AA
DEKHE	D IH K IY
DEKHEIN	D IH K IY N
DEKHEN	D EH K AH N
DEKHI	D IH K IY
DEKHIEYE	D IH K IY AY
DEKHIN	D IH K IH N
DEKHIYE	D IH K AY AY
DEKHNE	D IH K N
DEKHO	D IH K OW
DEKHTE	D IH K T
DEKHUN	D IH K AH N
DEKNA	D AH N AA
DELUSION	D IH L UW ZH AH N
DEMO	D EH M OW
DEN	D EH N
DENA	D IY N AH
DENE	D AH N IY
DENTAL	D EH N T AH L
DEO	D IY OW
DEOBAND	D IY AA B AH N D
DEOBANDI	D IY AH B AE N D IY
DEODAAS	D IY AA D AH Z
DEORRI	D IY AO R IY
DEPEND	D IH P EH N D
DEPRESSION	D IH P R EH SH AH N
DER	D ER
DEREENA	D IH R IY AH N AA
DERH	D EH R
DERHE	D AH R IY
DERICHOON	D IH R AH CH UW N
DESERT	D EH Z ER T
DESERT(2)	D IH Z ER T
DESH	D EH SH
DESI	D EH Z IY
DESIGN	D IH Z AY N
DESK	D EH S K
DESSIGHNERON	D IH S AY N AH R AH N
DETA	D AH T AA
DETE	D AH T IY
DETEY	D IY T IY
DETI	D AH T IY
DEVELOPER	D IH V EH L AH P ER
DEVELOPMENT	D IH V EH L AH P M AH N T
DEVI	D AH V IY
DEWEL	D AH W EH L
DEY	D EY
DEYA	D IY Y AA
DEYNA	D IY Y N AA
DHAA	D HH AA
DHAAL	D HH EY AH L
DHAAR	D HH EY AH R
DHAB	D HH AE B
DHABBAY	D HH AE B EY IY
DHABE	D HH EY B
DHAGE	D HH EY JH
DHAI	D HH EY
DHAJIYAN	D HH EY JH IY AY AH N
DHAL	D HH AE L
DHALAK	D HH AE L AH K
DHAMAKA	D HH AE M AH K AH
DHAMKA	D HH AE M K AH
DHAMKAA	D HH AE M K AH
DHAMKAANAY	D HH AE M K AA N EY IY
DHAMKI	D HH AE M K IY
DHANCHE	D HH AE NG K
DHANDHORA	D HH AE N D HH AH R AH
DHANDLI	D HH AE N D L IY
DHANG	D HH AE NG
DHANIYA	D HH EY N IY AY AH
DHANMP	D HH AE N M P
DHAR	D HH AA R
DHARA	D HH AE R AH
DHARALE	D HH AH R EY L
DHARAM	D HH AE R AH M
DHARAY	D HH AE R EY IY
DHARHEIN	D HH AH R IY N
DHARI	D HH AE R IY
DHARS	D HH AA R Z
DHAY	D HH EY IY
DHEEMI	D HH IY M IY
DHEERE	D HH IH R
DHELE	D HH IY L
DHENCHU	D HH EH NG K UW
DHER	D HH EH R
DHINGA	D HH IH N G AH
DHO	D HH OW
DHOBI	D HH AA B IY
DHOHAR	D HH AA AH R
DHOL	D HH AA L
DHONDH	D HH AA N D
DHONEKE	D HH AH N IY K
DHONK	D HH AO NG K
DHOOAN	D HH UW AH N
DHOOEN	D HH UW AH N
DHOOL	D HH UW L
DHOOM	D HH UW M
DHOONI	D HH UW N IY
DHOOP	D HH UW P
DHOYA	D HH OY AH
DHOYE	D HH OY
DHUL	D HH AH L
DHUNDEN	D HH AH N D AH N
DHUNDH	D HH AH N D
DHUWEN	D HH AH W AH N
DI	D IY
DI(2)	D AY
DIAGRAM	D AY AH G R AE M
DICTATION	D IH K T EY SH AH N
DID	D IH D
DIDNT	D IH D N T
DIFAA	D IH F AH
DIFFERENCE	D IH F ER AH N S
DIFFERENCE(2)	D IH F R AH N S
DIFFERENT	D IH F ER AH N T
DIFFERENT(2)	D IH F R AH N T
DIFFICULT	D IH F AH K AH L T
DIGITAL	D IH JH AH T AH L
DIGITAL(2)	D IH JH IH T AH L
DIJYE	D IH JH AY
DIKHA	D IH K AH
DIKHAVAY	D IH K AE V EY IY
DIKHAYA	D IH K EY AH
DIKHAYE	D IH K EY
DIKHAYEN	D IH K EY AH N
DIKHAYI	D IH K EY IY
DIKHLA	D IH K L AH
DIKHNE	D IH K N
DIL	D IH L
DILBARDASHTAH	D IH L B AH R D AE SH T AH
DILCHASPI	D IH L CH AE S IY
DILFAREB	D IH L F AH R AH B
DILIVERY	D AY L AH V EH R IY
DILJOI	D IH L JH OY
DILKHARASH	D IH L K AH R AH SH
DILLY	D IH L IY
DILNASHEEN	D IH L N AE SH IY AH N
DILON	D IH L AH N
DILRON	D IH L R AH N
DILRUBA	D IH L R UW B AH
DILSHAAD	D IH L SH AH D
DILSOZI	D IH L S AH Z IY
DILWAUN	D IH L W AH N
DIMAAGH	D IH M AH
DIMAGHI	D IH M AH IY
DIMAND	D IH M AH N D
DIN	D IH N
DINN	D IH N
DINO	D IY N OW
DINOSAURS	D AY N AH S AO R Z
DINOUN	D AH N AW N
DIPLOMACY	D IH P L OW M AH S IY
DIRECT	D ER EH K T
DIRECT(2)	D AY R EH K T
DIRECT(3)	D IH R EH K T
DIRECTOR	D ER EH K T ER
DIRECTOR(2)	D AY R EH K T ER
DIRECTOR(3)	D IY R EH K T ER
DIRECTOR(4)	D IH R EH K T ER
DIRHAM	D IH R AH M
DISASTER	D IH Z AE S T ER
DISCHARGE	D IH S CH AA R JH
DISCOVERY	D IH S K AH V ER IY
DISCOVERY(2)	D IH S K AH V R IY
DISTRICT	D IH S T R IH K T
DIVISION	D IH V IH ZH AH N
DIVISIONAL	D IH V IH ZH AH N AH L
DIYA	D AY AY AH
DIYE	D AY AY
DO	D UW
DOBAARA	D AA B AH R AH
DOBARA	D AA B AH R AH
DOCHAR	D UW CH AA R
DOCTOR	D AA K T ER
DOCTOR(2)	D AO K T ER
DODHEL	D AA D HH AH L
DODIYAN	D OW D IY AY AH N
DODRON	D AA D R AH N
DOEM	D OW AH M
DOESNT	D OW AH Z N T
DOG	D AO G
DOGANA	D AA G AH N AH
DOGAR	D AO G ER
DOGHLA	D AA L AH
DOGHLI	D AA L IY
DOGJLE	D AA G AH L
DOHRAANE	D AA R AH N
DOHRAYA	D AA R EY AH
DOJE	D OW JH
DOL	D AA L
DOLLAR	D AA L ER
DOLLAR(2)	D AO L ER
DOMAIN	D OW M EY N
DOMESTIC	D AH M EH S T IH K
DON	D AA N
DONERS	D AA N ER Z
DONO	D OW N OW
DONT	D AA N T
DOOB	D UW B
DOOBHAR	D UW B AH R
DOODH	D UW D
DOODHIYA	D UW D HH IY AY AH
DOODIYA	D UW D IY AY AH
DOOR	D AO R
DOORBEEN	D OW R B IY AH N
DOORRAS	D UH R AH Z
DOOSRI	D UW Z R IY
DOOSRON	D UW Z R AH N
DOPEHAR	D AA P AH AH R
DORAAN	D AO R EY AH N
DORAH	D AO R AH
DORANAY	D AH R AE N EY IY
DORANIYE	D AH R EY N IY AY
DOREN	D AO R AH N
DOREY	D AO R IY
DORNE	D AO R N
DOSHEEZA	D AH SH IY Z AH
DOSRA	D AA Z R AH
DOSRAY	D UW Z R EY
DOST	D AA S T
DOSTI	D AA S T IY
DOT	D AA T
DOTS	D AA T S
DOUBLE	D AH B AH L
DOUN	D AW N
DOWN	D AW N
DOZAKH	D AA Z AH K
DRAAMDAT	D R AA M D AH T
DRAMA	D R AA M AH
DRAONI	D R EY AH N IY
DRAWING	D R AO IH NG
DRILL	D R IH L
DRIVING	D R AY V IH NG
DROP	D R AA P
DROP(2)	D R AO P
DRUSTAGI	D R AH S T AH JH IY
DUA	D Y UW AH
DUAIYA	D Y UW EY AY AH
DUAON	D Y UW EY AH N
DUAYEN	D Y UW EY AH N
DUGNA	D AH G N AH
DUKH	D AH K
DUKHEN	D AH K AH N
DUKHI	D AH K IY
DUKHON	D AH K AH N
DUKHTAR	D AH K T AH R
DULHA	D AH L HH AH
DULHAN	D AH L AH N
DUM	D AH M
DUN	D AH N
DUNG	D AH NG
DUNIYA	D Y UW N IY AY AH
DUNIYAVI	D Y UW N IY AY AH V IY
DUNYA	D Y UW N AY AH
DUR	D AH R
DUROOOD	D Y UH R UW AH D
DURUST	D Y UH R AH S T
DUS	D AH Z
DUSHMAN	D AH SH M AH N
DUSHWAAR	D AH SH W EY AH R
DUSRAY	D AH Z R EY IY
DUTCH	D AH CH
DYOMALAIN	D AY AA M AH L EY N
E	IY
E	IY
EAANAT	IY AH N AH T
EACH	IY CH
EAGLES	IY G AH L Z
EASE	IY Z
EASIER	IY Z IY ER
EASY	IY Z IY
EDHAWCK	EH D HH AH K
EDUCATION	EH JH AH K EY SH AH N
EDUCATION(2)	EH JH Y UW K EY SH AH N
EE	IY
EEDEN	IY D AH N
EEFA	IY F AH
EENDHAN	IY N D AH N
EESAAR	IY S EY AH R
EFFECT	IH F EH K T
EFFECT(2)	IY F EH K T
EFFECT(3)	AH F EH K T
EFFORT	EH F ER T
EHAL	EH AH L
EHLE	EH L
EHLIYA	AH L IY AY AH
EHSAAN	EH S EY AH N
EHSAAS	EH S AH Z
EHTIJAJ	EH T AH JH AH JH
EID	AY D
EIGHT	EY T
EIGHTEEN	EY T IY N
EIGHTY	EY T IY
EIK	IY K
EJAZ	EH JH AH Z
EJAZ	EH JH AH Z
EK	EH K
EK(2)	IY K EY
EKI	EH K IY
ELCHI	EH L CH IY
ELECTION	IH L EH K SH AH N
ELECTRONICS	IH L EH K T R AA N IH K S
ELEMENTARY	EH L AH M EH N T R IY
ELEMENTARY(2)	EH L AH M EH N T ER R IY
ELEMENTARY(3)	EH L AH M EH N CH R IY
ELEVEN	IH L EH V AH N
ELEVEN(2)	IY L EH V AH N
EMAIL	IY M EY L
EMBASSY	EH M B AH S IY
EMERGENCY	IH M ER JH AH N S IY
EMERGENCY(2)	IY M ER JH AH N S IY
EMERGENGY	AH M AH R JH EH N JH IY
END	EH N D
ENGINE	EH N JH AH N
ENGINE(2)	IH N JH AH N
ENGINE	EH N JH AH N
ENGINE(2)	IH N JH AH N
ENGINEER	EH N JH AH N IH R
ENGLISH	IH NG G L IH SH
ENGLISH(2)	IH NG L IH SH
ENGRO	IH N G R OW
ENIHSAAR	AH N IH S EY AH R
ENLISH	EH N L AH SH
ENOUGH	IH N AH F
ENOUGH(2)	IY N AH F
EONE	IY OW N
EQAAN	EH K EY AH N
EQUITY	EH K W AH T IY
EUROPEAN	Y UH R AH P IY AH N
EUROPI	Y UW R AH P IY
EVENING	IY V N IH NG
EVENT	IH V EH N T
EVENT(2)	IY V EH N T
EVERYBODY	EH V R IY B AA D IY
EVERYONE	EH V R IY W AH N
EWAAN	Y UW EY AH N
EXAMINER	IH G Z AE M AH N ER
EXAMPLE	IH G Z AE M P AH L
EXCELLENT	EH K S AH L AH N T
EXCHANGE	IH K S CH EY N JH
EXCLUSIV	IH K S L UW S AH V
EXCLUSIVE	IH K S K L UW S IH V
EXCUSES	IH K S K Y UW S IH Z
EXCUSES(2)	IH K S K Y UW Z IH Z
EXECUTIVE	IH G Z EH K Y AH T IH V
EXIT	EH G Z IH T
EXIT(2)	EH K S AH T
EXTRA	EH K S T R AH
EYRI	EY R IY
F	EH F
F	EH F
FAAL	F AA L
FAASH	F AA SH
FABRICS	F AE B R IH K S
FACEBOOK	F EY S B UH K
FAIDA	F EY D AH
FAIRY	F EH R IY
FAISLA	F EY Z L AH
FAISLAY	F EY Z L EY
FAISLON	F EY Z L AH N
FAITH	F EY TH
FAIZ	F EY Z
FAIZ	F EY Z
FAIZAN	F EY AY Z AH N
FAJAR	F EY JH AH R
FAJIR	F AE JH AH R
FAKAR	F EY K ER
FAKHAR	F AE K AH R
FAKHRA	F AE K R AH
FALAK	F AE L AH K
FALALAIN	F AE L AH L EY N
FALAN	F EY L AH N
FALL	F AO L
FALL(2)	F AA L
FALSAFAY	F AE L S AE F EY IY
FAME	F EY M
FAMILY	F AE M AH L IY
FAMILY(2)	F AE M L IY
FAMILYOF	F AH M IH L AY AH F
FAMOUS	F EY M AH S
FAN	F AE N
FAOGH	F EY OW
FAQEER	F AH K IH R
FARAGH	F AE R AH
FARAHAM	F AA R AH HH AE M
FARAHUM	F AA R AH HH AH M
FARAIZ	F AH R EY Z
FARAWAN	F AA R AH W AA N
FAREB	F AE R AH B
FAREEQAIN	F AE R AH K EY N
FARIGH	F AE R IY
FARIQ	F AE R AH K
FARKHANDA	F AA R K AE N D AH
FARKHI	F AA R K IY
FARM	F AA R M
FARMAA	F AA R M AH
FARMAAYA	F AA R M AA AY AH
FARMAIYE	F AA R M EY AY
FARMAYA	F AA R M EY AH
FAROGDASHT	F AH R AA G D AH SH T
FAROKHT	F AE R AH K T
FAROOQ	F AE R AH K
FAROSH	F AE R AH SH
FARSI	F AA R S IY
FARSOODA	F AA R S UW D AH
FARWAYEN	F AA R W EY AH N
FARZ	F AA R Z
FASAL	F EY Z AH L
FASHION	F AE SH AH N
FASLEIN	F AE Z L IY N
FASLEN	F AE Z L AH N
FAST	F AE S T
FAT	F AE T
FATA	F AA T AH
FATAHYAAB	F AH T AE HH AY AH B
FAUG	F AO G
FAUGON	F AO G AH N
FAUJ	F AO JH
FAUJDARI	F AO JH D AH R IY
FAUJEIN	F AH JH IY N
FAUJION	F AO JH AH N
FAURI	F AO R IY
FAVOURITE	F EY V ER IH T
FAWAID	F AO EY D
FAYAZ	F EY AH Z
FAYAZI	F EY AH Z IY
FAZAL	F EY Z AH L
FAZEELAT	F EY Z IY L AH T
FEATURE	F IY CH ER
FEBRUARY	F EH B Y AH W EH R IY
FEBRUARY(2)	F EH B R UW EH R IY
FEDERAL	F EH D ER AH L
FEDERAL(2)	F EH D R AH L
FEDERATION	F EH D ER EY SH AH N
FEEDR	F IY D R
FEES	F IY Z
FEESAD	F IY S AE D
FEESEN	F IY S EH N
FEESON	F IY S AH N
FEHASH	F EH HH AH SH
FEHRIST	F EH R AH S T
FELLEN	F EH L AH N
FELLOW	F EH L OW
FEROZAN	F EH R AH Z AH N
FESLA	F EH Z L AH
FEW	F Y UW
FEY	F EY
FHRSTIN	F HH R S T IH N
FI	F AY
FI(2)	F IY
FIAN	F AY AH N
FIDA	F IH D AH
FIDRISHNZ	F IH D R AH SH N Z
FIELD	F IY L D
FIFTEEN	F IH F T IY N
FIFTY	F IH F T IY
FIGAAR	F IH G EY AH R
FIKAR	F AY K AH R
FIKRO	F IH K R OW
FIKRON	F IH K R AH N
FILM	F IH L M
FILMON	F IH L M AO N
FILSAAZ	F IH L S AH Z
FINALLY	F AY N AH L IY
FINANCE	F AH N AE N S
FINANCE(2)	F IH N AE N S
FINANCE(3)	F AY N AE N S
FIQHI	F IH K IY
FIQRE	F IH K R
FIRDOUS	F AH R D AH S
FIRE	F AY ER
FIRE(2)	F AY R
FIRQA	F AH R K AH
FIRST	F ER S T
FIRT	F AH R T
FISHAAR	F IH SH EY AH R
FISHER	F IH SH ER
FISHING	F IH SH IH NG
FITNESS	F IH T N AH S
FIVE	F AY V
FLAG	F L AE G
FLESH	F L EH SH
FLETCHER	F L EH CH ER
FLOOD	F L AH D
FLOOR	F L AO R
FLU	F L UW
FOAM	F OW M
FOCUS	F OW K AH S
FOCUS(2)	F OW K IH S
FOLAD	F AA L AH D
FOLDER	F OW L D ER
FOLLOWAN	F AA L OW AH N
FOOD	F UW D
FOOL	F UW L
FOOT	F UH T
FOQIAT	F AA K IY AH T
FOR	F AO R
FOR(2)	F ER
FOR(3)	F R ER
FORAN	F AO R AH N
FORCE	F AO R S
FORCED	F AO R S T
FOREST	F AO R AH S T
FOREST(2)	F AO R IH S T
FOREX	F AO R EH K S
FORGET	F ER G EH T
FORGET(2)	F AO R G EH T
FORMULAY	F AO R M Y AH L AH IY
FORTY	F AO R T IY
FORUM	F AO R AH M
FORWARD	F AO R W ER D
FOSTER	F AA S T ER
FOUJI	F AW JH IY
FOUNATION	F AW N EY SH AH N
FOUNTAIN	F AW N T AH N
FOUR	F AO R
FOURTEEN	F AO R T IY N
FRANCEESY	F R AE NG K IY Z IY
FRENCH	F R EH N CH
FRIEND	F R EH N D
FRIENDLY	F R EH N D L IY
FRIENDS	F R EH N D Z
FROM	F R AH M
FUGHAN	F AH AH N
FUJOOR	F Y UW JH OW AH R
FUN	F AH N
FUNDS	F AH N D Z
FUNGUS	F AH NG G AH S
FUNOON	F Y UW N UW N
FUQDAAN	F AH K D EY AH N
FURQAAN	F AH R K EY AH N
FUTURE	F Y UW CH ER
FUYUZ	F Y UW AY AH Z
FUZOOL	F Y UW Z UW L
G	JH IY
G	JH IY
G18	JH IY W AH N EY T
GA	G AA
GA(2)	JH IY EY
GA(3)	JH AO R JH AH
GAAF	G AA F
GAAM	G AA M
GAARI	G AA R IY
GADA	G AE D AH
GADGET	G AE JH AH T
GADHA	G AE D HH AH
GADHE	G AE D HH
GADHI	G AE D HH IY
GADHO	G AE D HH OW
GADRI	G AE D R IY
GAE	G AY
GAGE	G EY JH
GAGGAN	G AE G AH N
GAH	G AE
GAI	G EY
GAINI	G EY N IY
GAJJAR	G AE JH AH R
GALE	G EY L
GALLERY	G AE L ER IY
GALLIYON	G AE L IY IY AO N
GAME	G EY M
GAMES	G EY M Z
GAND	G AE N D
GANDUM	G AE N D AH M
GANGA	G AE N G AH
GANGOLI	G AE N G AH L IY
GANGS	G AE NG Z
GANGSTAR	G AE NG S T AA R
GAO	G EY OW
GAON	G EY AH N
GARAGE	G ER AA ZH
GARAJ	G AE R AH JH
GARAMJOSHI	G AH R AE M JH AH SH IY
GARAVARI	G AH R AE V AH R IY
GARBARH	G AA R B AH R
GARDAN	G AA R D AH N
GARDANI	G AA R D AH N IY
GARDISH	G AA R D AH SH
GARDOGHUBAR	G AA R D AH UW B AH R
GARDZI	G AA R D Z IY
GARGHARAHAT	G AH R AE R AH HH AH T
GARH	G AA R
GARHA	G AA R AH
GARHON	G AA R AH N
GARI	G AA R IY
GARIYAAN	G AH R IY AY EY AH N
GARLAND	G AA R L AH N D
GARMA	G AA R M AH
GARMI	G AA R M IY
GAROHON	G AE R AH HH AH N
GARVEEDA	G AA R V IY D AH
GASEIN	G EY S IY N
GASHT	G AE SH T
GASKE	G AE S
GATH	G AE TH
GATHA	G AE TH AH
GAY	G EY
GAYA	G EY AH
GAYARA	G EY AH R AH
GAYARAH	G EY AH R AH
GAYARHAVI	G EY AA R AH V IY
GAYE	G EY
GAYEEN	G EY IY AH N
GAYEN	G EY AH N
GAYEON	G EY IY AH N
GAYI	G EY IY
GAZ	G AA Z
GAZ(2)	G AE Z
GDRIE	G D R AY
GE	JH IY
GEAR	G IH R
GEEDAR	JH IY D AH R
GEER	G IH R
GEHAR	JH EH AH R
GEHMA	JH EH M AH
GEHMI	JH EH M IY
GEHRA	JH EH R AH
GEHRE	JH EH R
GEHUN	JH EH HH AH N
GENDE	JH EH N D
GENE	JH IY N
GENERAL	JH EH N ER AH L
GENERAL(2)	JH EH N R AH L
GENERATION	JH EH N ER EY SH AH N
GENERIC	JH AH N EH R IH K
GENUINE	JH EH N Y UW AH N
GENUINE(2)	JH EH N Y UW AY N
GEO	JH IY OW
GEOGRAPHY	JH IY AA G R AH F IY
GEOMETERY	JH IY AH M AH T EH R IY
GEORGE	JH AO R JH
GERMANY	JH ER M AH N IY
GET	G EH T
GET(2)	G IH T
GH	JH IY
GHA	G AA
GHAAO	G AA OW
GHAAS	G AA Z
GHABBAN	G AE B AH N
GHADDAR	G AE D AH R
GHADOOD	G AH D UW D
GHAEEN	G IY AH N
GHAFIL	G AE F AH L
GHAFLAT	G AE F L AH T
GHAGRA	G AE G R AH
GHAIB	G EY B
GHAIL	G EY L
GHAIN	G EY N
GHAIR	G AE AH R
GHAIRAT	G AE AH R AH T
GHAIRQANOONI	G AH AH R K AH N UW N IY
GHAIRRASMI	G AE AH R AE Z M IY
GHAIZ	G EY Z
GHALAT	G AE L AH T
GHALIB	G AE L AH B
GHAM	G AE M
GHAMBEER	G AE M B IH R
GHAMBIR	G AE M B AH R
GHANERI	G AE N AH R IY
GHANGHOR	G AE N AH R
GHANNI	G AE N IY
GHANTA	G AE N T AH
GHANTE	G AE N T
GHANTON	G AE N T AH N
GHAR	G AA R
GHARARE	G AE R AH R
GHAREEB	G AH R IY B
GHARELU	G AE R AH L UW
GHARI	G AE R IY
GHARIYON	G AH R IY AY AH N
GHARMIYON	G AA R M IY AY AH N
GHARON	G AE R AH N
GHARRIYAN	G AE R IY AY AH N
GHASAB	G AE S AH B
GHASEET	G EY S IY T
GHASHI	G AE SH IY
GHATA	G AE T AH
GHAUR	G AO R
GHAUZ	G AO Z
GHAYAB	G EY AH B
GHAYYUR	G EY AY AH R
GHAZAI	G AE Z EY
GHAZAL	G EY Z AH L
GHAZLEN	G AE Z L AH N
GHAZLIYAAT	G AE Z L IY AY AH T
GHAZLON	G AE Z L AH N
GHAZWAH	G AE Z W AH
GHEE	G IY
GHEREY	G IY R IY
GHESSU	G EH S UW
GHHOR	G HH AO R
GHILAAF	G IH L AH F
GHINA	G IH N AH
GHINAONA	G AH N EY AH N AH
GHINAONE	G IH N EY OW N
GHINN	G IH N
GHIRAO	G IH R EY OW
GHIRE	G AY R
GHISSA	G IH S AH
GHIYA	G AY AY AH
GHIZA	G IH Z AH
GHIZAON	G IH Z EY AH N
GHOGHA	G AA AH
GHOL	G AA L
GHOO	G UW
GHOOM	G UW M
GHOONGAT	G UW N G AH T
GHOONT	G UW N T
GHOOR	G OW AH R
GHOORNE	G UH R N
GHOOST	G UW S T
GHOR	G AO R
GHORAY	G AO R EY IY
GHOS	G AA Z
GHOT	G AA T
GHSE	G S IY
GHUBAR	G Y UW B AH R
GHUCHON	G AH CH AH N
GHUFOOR	G Y UW F OW AH R
GHUH	G UW
GHUL	G AH L
GHULAAM	G Y UW L AH M
GHULAIL	G Y UW L EY L
GHULLEN	G AH L AH N
GHUMMAN	G AH M AH N
GHUNGHROO	G AH N R UW
GHUNGREYALU	G AH N G R EY AH L UW
GHUNNA	G AH N AH
GHUNODGHI	G Y UW N AA JH HH IY
GHURIYA	G Y AH R IY AY AH
GHUSNA	G AH Z N AH
GHUSNAY	G AH Z N EY IY
GHUSS	G AH S
GHUTHLIAN	G AH TH L IY AH N
GI	JH IY
GIDH	JH IH D
GIFT	G IH F T
GIGA	JH IH G AH
GILLANI	JH IH L AH N IY
GINVATE	JH IH N V EY T
GIRA	JH IH R AH
GIRADAY	JH AH R AE D EY IY
GIRAFTAAR	JH AH R AE F T EY AH R
GIRAFTAR	JH AH R AE F T AH R
GIRAHA	JH IH R AH HH AH
GIRAN	JH AY R AH N
GIRANA	JH IH R AH N AH
GIRANKADDAR	JH AH R AE NG K AE D AH R
GIRGIRA	JH AH R JH AH R AH
GIRHEN	JH IH R AH N
GIRI	JH IH R IY
GIRL	G ER L
GIRLFRIEND	G ER L F R EH N D
GIRLS	G ER L Z
GIRNAY	JH AH R N EY IY
GIRUN	JH IH R AH N
GIVE	G IH V
GIYA	JH AY AY AH
GLACIER	G L EY SH ER
GLISHYR	G L IH SH AH R
GLOBLE	G L AA B AH L
GLOVES	G L AH V Z
GLYCERINE	G L IH S AH R AH N
GO	G OW
GOAT	G OW T
GOBAR	G AA B ER
GOD	G AA D
GODAAZ	G AA D AH Z
GODI	G OW D IY
GODOWN	G OW D AW N
GOH	G OW
GOHAR	G AA AH R
GOING	G OW IH NG
GOING(2)	G OW IH N
GOJAR	G OW JH AA R
GOL	G AA L
GOLAI	G AA L EY
GOLD	G OW L D
GOLDRWI	G OW L D R W IY
GOLF	G AA L F
GOLF(2)	G AO L F
GOLI	G OW L IY
GOLON	G AA L AH N
GOND	G AA N D
GONNA	G AA N AH
GOO	G UW
GOOD	G UH D
GOOD(2)	G IH D
GOOGLE	G UW G AH L
GOONDHEN	G UW N D AH N
GOONGE	G UW N JH
GOONJ	G UW N JH
GOREY	G AO R IY
GORILLA	G ER IH L AH
GOSHA	G OW SH AH
GOSHE	G AA SH
GOSHON	G AA SH AH N
GOSHT	G AA SH T
GOSHWARA	G AA SH W AH R AH
GOT	G AA T
GOTHON	G OW TH AO N
GOVERNANCE	G AH V ER N AH N S
GOVERNMENT	G AH V ER N M AH N T
GOVERNOR	G AH V ER N ER
GOWN	G AW N
GOYA	G OY AH
GOZRI	G AA Z R IY
GRADE	G R EY D
GRADUATION	G R AE JH UW EY SH AH N
GRADUATION(2)	G R AE JH AH W EY SH AH N
GRAMOPHONE	G R AE M AH F OW N
GREAT	G R EY T
GROH	G R OW
GROUND	G R AW N D
GROUP	G R UW P
GROWTH	G R OW TH
GTHRHI	G TH R IY
GUARDS	G AA R D Z
GUCHE	G AH CH
GUDDA	G AH D AH
GUFTAGU	G AH F T AE G Y UW
GUH	G UW
GUID	G UW D
GUINESE	G UW N IY Z
GUJJAR	G AH JH AH R
GUJRAATI	G AH JH R AH T IY
GUL	G AH L
GULDASTA	G AH L D AE S T AH
GULEHRI	G Y UW L AH R IY
GULREZ	G AH L R AH Z
GULSHAN	G AH L SH AH N
GULSITAN	G AH L S AH T AH N
GUM	G AH M
GUMSHUDAA	G AH M SH UW D AH
GUN	G AH N
GUNAHGAAR	G Y UW N AE G EY AH R
GUNAHON	G Y UW N AH HH AH N
GUNJELAQ	G AH N JH AH L AH K
GUNNAH	G AH N AH
GUNNAHON	G AH N AH HH AH N
GURAIZ	G Y AH R EY Z
GURBAT	G AH R B AH T
GURGA	G AH R G AH
GURGE	G AH R JH
GURGEY	G AH R JH IY
GURIYA	G Y AH R IY AY AH
GUSTAAKHI	G AH S T AA K IY
GUTHI	G AH TH IY
GUTHIYAN	G AH TH IY AY AH N
GUTHLI	G AH TH L IY
GUYS	G AY Z
GUZAARNE	G Y UW Z AH R N
GUZAARUN	G Y UW Z AH R AH N
GUZAR	G Y UW Z AH R
GUZARTA	G Y UW Z AA R T AH
GUZARUN	G Y UW Z AH R AH N
GUZASHTA	G Y UW Z AE SH T AH
GUZEEN	G Y UW Z IY AH N
GUZEER	G Y UW Z IH R
GUZISHTA	G Y UW Z IH SH T AH
GUZRAY	G AH Z R EY IY
GUZRI	G AH Z R IY
GYA	JH AY AH
GYARA	JH AY AH R AH
GYARWIEN	JH AY AA R W IY AH N
GYMKHANH	JH IH M K AH N
H	EY CH
H	EY CH
HA	HH AA
HAADSE	HH AA D S
HAAFIZ	HH AA F AH Z
HAAJI	HH AA JH IY
HAAL	HH EY AH L
HAAR	HH AA R
HAASIL	HH AA S AH L
HAATH	HH AA TH
HAAVY	HH AA V IY
HAAZRI	HH AA Z R IY
HABHA	HH AE B HH AH
HABIB	HH AH B IY B
HABS	HH AE B Z
HABSHI	HH AE B SH IY
HACKEL	HH AE K AH L
HAD	HH AE D
HADAYYAT	HH AH D EY AY AH T
HADD	HH AE D
HADDI	HH AE D IY
HADEES	HH EY D IY Z
HADSATI	HH AE D S AH T IY
HAE	HH IY
HAFEEZ	HH EY F IY Z
HAFIZ	HH AE F AH Z
HAFTA	HH AE F T AH
HAFTE	HH AE F T
HAFZE	HH AE F Z
HAI	HH EY
HAIBAT	HH EY B AH T
HAIDER	HH EY D ER
HAIF	HH EY F
HAIL	HH EY L
HAIN	HH EY N
HAIR	HH EH R
HAIRAN	HH AE AH R AH N
HAIRAT	HH AE AH R AH T
HAISIYAT	HH EY S IY AY AH T
HAIZA	HH EY Z AH
HAJHOOM	HH AE JH HH UW M
HAJJ	HH AE JH
HAJJAJ	HH AE JH AH JH
HAJU	HH AE JH UW
HAJVERI	HH AE JH AH R IY
HALAANK	HH AE L AH NG K
HALAAT	HH AE L AH T
HALAF	HH AE L AH F
HALAK	HH AE L AH K
HALAT	HH AE L AH T
HALF	HH AE F
HALI	HH AE L IY
HALKI	HH AE L K IY
HALMET	HH AE L M AH T
HALN	HH AE L N
HALQA	HH AE L K AH
HAMAL	HH EY M AH L
HAMARA	HH AE M AH R AH
HAMARAY	HH AE M AH R EY
HAMAREY	HH AE M AH R IY
HAMEIN	HH EY M IY N
HAMESHA	HH AE M AH SH AH
HAMID	HH AH M IY D
HAMIL	HH AE M AH L
HAMLA	HH AE M L AH
HAMLE	HH EY M AH L
HAMLON	HH AE M L AH N
HAMRA	HH AE M R AH
HAMSHEERA	HH AE M SH AH R AH
HAMZA	HH AE M Z AH
HAMZAAD	HH AE M Z AH D
HAN	HH AA N
HAN(2)	HH AE N
HANEEF	HH EY N IY F
HANGAAMI	HH AE N G AH M IY
HANGER	HH AE NG ER
HANOOZ	HH AH N UW Z
HANSE	HH AE N S
HANSNE	HH AE N S N
HAOSNG	HH EY AH Z NG
HAQ	HH AE K
HAQEEQAT	HH AH K IY K AH T
HAQOOMAT	HH AH K UW M AH T
HAQOOQ	HH AE K AH K
HAR	HH AA R
HARA	HH EH R AH
HARASAN	HH AE R AH Z AH N
HARD	HH AA R D
HARDWARE	HH AA R D W EH R
HARE	HH EH R
HAREEFON	HH AH R IY F AH N
HARFON	HH AA R F AH N
HARGIZ	HH AA R JH AH Z
HARTAL	HH AA R T AH L
HARVERTER	HH AA R V AH R T AH R
HAS	HH AE Z
HAS(2)	HH AH Z
HASEEN	HH EY Z IY AH N
HASHIYE	HH AE SH IY AY
HASHMI	HH AE SH M IY
HASHMI(2)	HH AA SH M IY
HASHR	HH AE SH R
HASIL	HH AE S AH L
HASPANWI	HH AE S AE N W IY
HASWANI	HH AE S W AH N IY
HATANA	HH AE T AH N AH
HATH	HH AE TH
HATHELI	HH AE TH AH L IY
HATHEY	HH AE T HH EY
HATHON	HH AE TH AH N
HATHORAY	HH AH TH AO R EY IY
HATHYAAR	HH AH TH AY EY AH R
HAULNAAK	HH AO L N AH K
HAUZ	HH AO Z
HAVE	HH AE V
HAVEIDA	HH EY V EY D AH
HAVELY	HH EY V L IY
HAY	HH EY
HAYAT	HH EY AH T
HAYYAT	HH EY AY AH T
HAZAAR	HH AE Z EY AH R
HAZAN	HH EY Z AH N
HAZAR	HH EY Z ER
HAZARWEIN	HH AE Z AH R W IY N
HAZEEN	HH EY Z AH N
HAZIYANI	HH EY Z IY AY AH N IY
HAZMI	HH AE Z M IY
HAZOOR	HH AE Z OW AH R
HAZRAAT	HH AE Z R AH T
HAZRAT	HH AE Z R AH T
HE	HH IY
HEAD	HH EH D
HEADQUARTER	HH EH D K W AO R T ER
HEADQUARTER(2)	HH EH D K AO R T ER
HEALTH	HH EH L TH
HEAR	HH IY R
HEAVY	HH EH V IY
HEE	HH IY
HEECH	HH IY CH
HEENG	HH IY NG
HEIN	HH AY N
HELLO	HH AH L OW
HELLO(2)	HH EH L OW
HELLO	HH AH L OW
HELLO(2)	HH EH L OW
HELP	HH EH L P
HELPS	HH EH L P S
HER	HH ER
HERAAN	HH EH R EY AH N
HERE	HH IY R
HERION	HH IY R IY AH N
HERO	HH IH R OW
HERO(2)	HH IY R OW
HEROEN	HH IY R OW AH N
HESIYAT	HH IY S IY AY AH T
HEY	HH EY
HF	EY CH F
HI	HH AY
HIA	HH AY AH
HICHKICHAHAT	HH IH CH IH CH AH HH AH T
HIDAYAT	HH IH D EY AH T
HIFAZAT	HH IH F AH Z AH T
HIFZ	HH IH F Z
HIJAN	HH AY JH AH N
HIJJAY	HH IH JH EY IY
HIJJON	HH IH JH AH N
HIJOYA	HH IH JH OY AH
HIJR	HH IH JH R
HIJRA	HH IH JH R AH
HIJRAAN	HH IH JH R EY AH N
HIJRAT	HH IH JH R AH T
HIJRE	HH AY JH AH R
HIJRHON	HH IH JH R AH N
HIJRI	HH IH JH R IY
HIMAYAT	HH IH M EY AH T
HINDU	HH IH N D UW
HINDUO	HH IH N D Y UW OW
HINDUSTANI	HH IH N D AH S T AH N IY
HINSE	HH IH N S
HINSO	HH IH N S OW
HISA	HH IH S AH
HISAS	HH IH S AH Z
HISB	HH IH Z
HISSA	HH IH S AH
HISSAY	HH AY Z S EY
HISSE	HH IH S
HISSON	HH IH S AO N
HN	EY CH N
HO	HH OW
HOGA	HH OW G AH
HOGAYA	HH AA G EY AH
HOGAYE	HH AA G EY
HOGI	HH OW JH IY
HOGYA	HH AA JH AY AH
HOI	HH OY
HOJA	HH OW JH AH
HOJAYE	HH AA JH EY
HOME	HH OW M
HOMEOPATHIC	HH OW M IY OW P AE TH AH K
HOMEOPATHY	HH OW M IY OW P AE TH IY
HON	HH AA N
HONA	HH OW N AH
HONAY	HH AA N EY IY
HONDA	HH AO N D AH
HONE	HH OW N
HONEY	HH AH N IY
HONGAY	HH AA N G EY IY
HONSLE	HH AA N S AH L
HOODA	HH UW D AH
HOPE	HH OW P
HOSH	HH AA SH
HOSHIYAR	HH AH SH IY AY AH R
HOSHMNDI	HH AA SH M N D IY
HOSHRUBA	HH AA SH R UW B AH
HOSHYARI	HH AH SH AY AH R IY
HOSLA	HH AA Z L AH
HOSTESS	HH OW S T AH S
HOTA	HH OW T AH
HOTAY	HH AA T EY IY
HOTE	HH OW T
HOTI	HH OW T IY
HOUN	HH AW N
HOUSE	HH AW S
HOUSES	HH AW S AH Z
HOUSES(2)	HH AW S IH Z
HOW	HH AW
HOWA	HH OW AH
HOZRI	HH AA Z R IY
HU	HH UW
HUA	HH UW AH
HUA(2)	HH W AA
HUB	HH AH B
HUDOOD	HH Y UW D UW D
HUDOODON	HH Y UW D UW D AH N
HUE	HH Y UW
HUFAAZ	HH Y UW F AH Z
HUI	HH UW IH
HUIN	HH UW N
HUJAT	HH Y UW JH AH T
HUJJAT	HH AH JH AH T
HUJOOM	HH Y UW JH UW M
HUKOOMAT	HH Y UW K UW M AH T
HULIYA	HH Y UW L IY AY AH
HUM	HH AH M
HUMA	HH Y UW M AH
HUMARA	HH Y UW M AH R AH
HUMARAY	HH AH M AH R EY
HUMARI	HH Y UW M AH R IY
HUMARY	HH AH M EH R IY
HUMAY	HH Y UW M EY IY
HUMJOLIYON	HH AH M JH AH L IY AY AH N
HUMRA	HH AH M R AH
HUMSAFFAR	HH AH M Z AE F ER
HUMUMAR	HH Y UW M Y UW M AH R
HUMWAAR	HH AH M W EY AH R
HUN	HH AH N
HUNDRED	HH AH N D R AH D
HUNDRED(2)	HH AH N D R IH D
HUNDRED(3)	HH AH N ER D
HUNDRED(4)	HH AH N D ER D
HUNGAMA	HH AH N G AH M AH
HUNGRY	HH AH NG G R IY
HUQMARAAN	HH AH K M AE R EY AH N
HUQOOQ	HH AH K AH K
HURIYYAT	HH Y UH R IY AY AY AH T
HURMATI	HH AH R M AH T IY
HURON	HH Y UW R AA N
HURON(2)	HH Y UH R AA N
HUSAN	HH Y UW Z AH N
HUSN	HH AH Z N
HUSOOL	HH Y UW S UW L
HUSSAIN	HH UW S EY N
HUSSAIN	HH UW S EY N
HUSSAINI	HH AH S AH N IY
HUVE	HH Y UW V
HWA	HH W AA
HYDERABAD	HH AY D EH R AH B AE D
HYDERABAD(2)	HH AY D ER AH B AE D
HYDROGEN	HH AY D R AH JH AH N
HYPHEN	HH AY F AH N
I	AY
I	AY
IBLAAGH	IH B L AH
IBRAHIM	IH B R AA HH IY M
IBRAT	IH B R AH T
IBTIDAYI	IH B T IH D EY IY
IDAARAY	AH D AA R EY IY
IDARAY	AH D AE R EY IY
IDARON	IH D AH R AH N
IDGHAM	IH JH HH AH M
IF	IH F
IFFAT	IH F AH T
IFLAAS	IH F L AH Z
IFRAAT	IH F R AH T
IHTRAAM	IH T R AH M
IJAAD	IH JH AH D
IJAZAT	IH JH AH Z AH T
IJLAAS	IH JH L AH Z
IJNAAS	IH JH N AH Z
IJRAH	IH JH R AH
IJTAMAI	IH JH T AH M EY
IJTIMAAT	IH JH T AH M AH T
IKATEES	IH K AH T IY Z
IKATHI	IH K AH TH IY
IKATIS	AY K EY T AH S
IKATTIS	AH K AE T AH S
IKEESWEN	AH K IY S W AH N
IKHATTAR	IH K AE T AH R
IKHILA	IH K AH L AH
IKHRAAJ	IH K R AH JH
IKHRAJAAT	IH K R AH JH AH T
IKHTIAR	IH K T IY AH R
IKHTIYAAR	IH K T IY AY EY AH R
IKHTIYAR	IH K T IY AY AH R
IKHWAN	IH K W AH N
IKIS	AY K AH S
IKKIIS	IH K IY AH S
IKSATH	IH K S AH TH
IKTALIIS	IH K T EY L IY AH S
IKTTALIIS	IH K T EY L IY AH S
IKYANVE	IH K AY AH N V
IKYASSI	IH K AY AE S IY
IKYAWAN	AH K AY AH AH N
ILAAJ	IH L AH JH
ILAAQON	IH L AH K AH N
ILAAWA	IH L AH W AH
ILAHIYAAT	IH L AH HH IY AY AH T
ILAM	IH L AH M
ILAQA	IH L AH K AH
ILAQAI	IH L AH K EY
ILAQE	IH L AH K
ILAWA	IH L AH AH
ILHAAQ	IH L HH AH K
ILM	IH L M
ILZAAM	IH L Z AH M
IM	IH M
IMAGE	IH M AH JH
IMAGE(2)	IH M IH JH
IMDAAD	IH M D AA D
IMMIGRATION	IH M AH G R EY SH AH N
IMPORTANT	IH M P AO R T AH N T
IMRAAZ	IH M R AA Z
IMRAN	IH M R AE N
IMTEHAN	IH M T EH AH N
IMTIHAN	IH M T IH AH N
IN	IH N
INDUSTRY	IH N D AH S T R IY
INEQAAD	AH N EH K AH D
INFARADI	IH N F AE R AH D IY
INFECTION	IH N F EH K SH AH N
INFLOENZA	IH N F L OW EH N Z AH
INFORCEMENT	IH N F OW R S M AH N T
INFORMATION	IH N F AO R M EY SH AH N
INHE	IH N HH IY
INHETAAT	IH N HH EH T AH T
INJECTION	IH N JH EH K SH AH N
INJURY	IH N JH ER IY
INKE	IH N K IY
INKESHAAF	IH N K EH SH AH F
INNINGS	IH N IH NG Z
INQELAAB	IH N K EH L AH B
INSAAN	IH N S EY AH N
INSAANIYAT	IH N S AH N IY AY AH T
INSECTY	IH N S EH K T IY
INSHAALLAH	IH N SH AA L AH
INSHAIYA	IH N SH EY AY AH
INSIDE	IH N S AY D
INSULATION	IH N S AH L EY SH AH N
INSULIN	IH N S AH L AH N
INSURANCE	IH N SH UH R AH N S
INTAZAR	IH N T EY Z AH R
INTEHAI	IH N T EH HH EY
INTEHAON	IH N T EH HH EY AH N
INTEKHABAAT	IH N T EH K AH B AH T
INTELIGENCE	IH N T EH L AH JH AH N S
INTELLECTUAL	IH N T AH L EH K CH UW AH L
INTELLECTUAL(2)	IH N AH L EH K CH UW AH L
INTELLIGANCE	IH N T EH L AH JH AH N S
INTENDENT	IH N T EH N D AH N T
INTEQAAL	IH N T EH K EY AH L
INTERFACE	IH N T ER F EY S
INTERFACE(2)	IH N ER F EY S
INTERMEDIATE	IH N T ER M IY D IY IH T
INTERMEDIATE(2)	IH N ER M IY D IY IH T
INTERSECTION	IH N T ER S EH K SH AH N
INTEZAAM	IH N T EH Z AH M
INTHAN	IH N TH AH N
INVESTMENT	IH N V EH S T M AH N T
INVESTMENT(2)	IH N V EH S M AH N T
INVOLVEMENT	IH N V AA L V M AH N T
INZABAATI	IH N Z AE B AH T IY
INZIMAM	IH N Z IH M AH M
IODINE	AY AH D AY N
IQAAN	IH K EY AH N
IQBAL	IH K B AH L
IQDAMAAT	IH K D AH M AH T
IQRAAR	IH K R EY AH R
IQTEDAR	IH K T AH D AH R
IQTISADI	IH K T IH S AH D IY
IRANI	IH R AA N IY
IRAQI	IH R AE K IY
IRAQI(2)	IY R AE K IY
IRAQI(3)	AY R AE K IY
IRFAAN	AH R F EY AH N
IRRIGATION	IH R AH G EY SH AH N
IRSHAAD	AH R SH AH D
IRTIASH	AH R T IY AH SH
IS	IH Z
IS	IH Z
ISAQ	IH S AH K
ISHAAL	IH SH EY AH L
ISHARA	IH SH AH R AH
ISHKHAAS	IH SH AH Z
ISHQ	IH SH
ISHRAT	IH SH R AH T
ISHTIYAL	IH SH T IY AY AH L
ISI	IH S IY
ISIYAN	AH S IY AY AH N
ISLAMABAD	IH S L AE M AH B AE D
ISLAMI	IH Z L AA M IY
ISNA	IH Z N AH
ISPAGHOL	IH S AH AH L
ISQAAT	IH S AH T
ISRAELY	IH Z R AH L IY
ISS	IH Z
ISSE	IH S
ISSUE	IH SH UW
ISSUES	IH SH UW Z
ISTAFSAAR	IH S T AE F S EY AH R
ISTAGHASA	IH S T AE AH S AH
ISTAGHFAAR	IH S T AE F EY AH R
ISTAGHNA	IH S T AH N AH
ISTAGHRAQ	IH S T AH R AH K
ISTEEFEY	IH S T IY F IY
ISTEFAADE	IH S T AH F AH D
ISTEHFAMIYA	IH S T AH F AH M IY AY AH
ISTEHQAAQ	IH S T EH HH K AH K
ISTEHSALI	IH S T EH S AH L IY
ISTEMAAL	IH S T EH M EY AH L
ISTHAAN	IH S TH EY AH N
ISTIMAAL	IH S T IH M EY AH L
ISTIQLAL	IH S T IH K L AH L
IT	IH T
ITEHAAD	IH T AH HH AH D
ITLAAT	IH T L AH T
ITNA	IH T N AH
ITS	IH T S
ITS	IH T S
ITTAFAQ	IH T AH F AH K
ITWAR	IH T W AH R
IYE	AY AY
IZAFA	IH Z AH F AH
IZAFEY	AH Z EY F IY
IZDAHAM	IH Z D AH HH AH M
IZHAAR	IH Z HH EY AH R
IZJ	IH Z
IZZAT	IH Z AH T
J	JH EY
J	JH EY
J310K10014438	JH EY TH R IY W AH N Z IY R OW K EY W AH N Z IY R OW Z IY R OW W AH N F OW R F OW R TH R IY EY T
JA	Y AA
JAA	JH AA
JAADOYI	JH AA D OY IY
JAAL	JH EY AH L
JAALI	JH AA L IY
JAAMIYAT	JH AH M IY AY AH T
JAAN	Y AA N
JAAN(2)	JH AE N
JAANA	JH AA N AH
JAANTEY	JH AA N T IY
JAARI	JH AA R IY
JAATA	JH AA T AH
JAB	JH AE B
JABEEN	JH EY B IY AH N
JABRA	JH AE B R AH
JABRE	JH EY B AH R
JABRI	JH AE B R IY
JABRON	JH AE B R AH N
JACHE	JH AE CH
JACHHEN	JH AE CH AH N
JACHTA	JH AE CH T AH
JACKET	JH AE K AH T
JACKET(2)	JH AE K IH T
JAD	JH AE D
JADEED	JH EY D IH D
JAD-O-JEHAD	JH AE D OW JH EH HH AH D
JADOLE	JH AH D OW L
JADOOGAR	JH AH D UW G AH R
JADOON	JH AH D UW N
JAFRY	JH AE F R IY
JAGA	JH AE G AH
JAGAH	JH AE G AH
JAGEERDAROON	JH EY JH IH R D AH R UW N
JAGHON	JH AE AH N
JAGUAR	JH AE G W AA R
JAH	JH AE
JAHAN	JH AE AH N
JAHANGIR	JH AH HH AE N JH AH R
JAIB	JH EY B
JAIDAD	JH EY D AH D
JAIL	JH EY L
JAISA	JH EY S AH
JAISAY	JH EY S EY IY
JAISE	JH EY Z
JAISI	JH EY S IY
JAIZA	JH EY Z AH
JAKRAN	JH AE K R AH N
JAL	JH AE L
JALALA	JH AE L AH L AH
JALAU	JH AE L AH
JALD	JH AE L D
JALDI	JH AE L D IY
JALHI	JH AE L HH IY
JALOOSON	JH AH L UW S AH N
JALSA	JH AE L S AH
JALSAY	JH AE L S EY IY
JALSON	JH AE L S AH N
JALWON	JH AE L W AH N
JAMAAT	JH AE M AH T
JAMAT	JH AE M AH T
JAME	JH EY M
JAMEA	JH EY M IY AH
JAMGHATTA	JH AH M AE T AH
JAMHOORIYET	JH AE M HH AH R IY AY AH T
JAMIYAT	JH EY M IY AY AH T
JAMSHED	JH AE M SH EH D
JAN	JH AE N
JANA	JH AE N AH
JANAAB	JH AE N AH B
JANAB	JH AE N AH B
JANAM	JH AE N AH M
JANAZA	JH AE N AH Z AH
JANE	JH EY N
JANGJU	JH AE N G UW
JANGON	JH AE N G AH N
JANIB	JH AE N AH B
JANIBDAR	JH AH N IH B D AH R
JANTA	JH AE N T AH
JANTEY	JH AE N T IY
JANU	JH AE N UW
JANUARY	JH AE N Y UW EH R IY
JAO	JH EY OW
JARGA	JH AA R G AH
JARH	JH AA R
JARHIAT	JH AA R IY AH T
JARHON	JH AA R AH N
JARI	JH AE R IY
JARRAIN	JH AA R EY N
JASA	JH AE S AH
JASHAN	JH AE SH AH N
JASOOSI	JH AH S UW S IY
JAST	JH AE S T
JAT	JH AE T
JATA	JH AE T AH
JATI	JH AE T IY
JAUN	JH AO N
JAWAB	JH AO AH B
JAWAR	JH AO ER
JAWED	JH AO D
JAYA	JH AY AH
JAYE	JH EY
JAYEN	JH EY AH N
JAYUN	JH EY AH N
JAYYAD	JH EY AY AH D
JAZBAAT	JH AE Z AH T
JAZO	JH AE Z OW
JAZZ	JH AE Z
JEE	JH IY
JEEM	JH IY M
JEESH	JH IY SH
JEEWAN	JH IY W AH N
JEHAD	JH EH HH AH D
JEHAL	JH EH AH L
JEHTE	JH EH T
JEORI	JH IY AH R IY
JESE	JH IY Z
JEVAN	JH IY V AH N
JEWELERY	JH UW AH L AH R IY
JEWISH	JH UW IH SH
JHAAG	JH HH AA G
JHAGRA	JH HH AE G R AH
JHAGRALOO	JH HH AE G R AH L UW
JHAGRE	JH HH AE G AH R
JHAGRON	JH HH AE G R AH N
JHAIYAN	JH HH EY AY AH N
JHALAK	JH HH AE L AH K
JHALAR	JH HH EY L AH R
JHANDE	JH HH AE N D
JHANGVI	JH HH AE N G IY
JHANKNE	JH HH AE NG K N
JHARAP	JH HH AE R AH P
JHARION	JH HH AE R IY AH N
JHARIYON	JH HH AH R IY AY AH N
JHARNE	JH HH AA R N
JHAROO	JH HH AE R UW
JHATKAY	JH HH AE T EY IY
JHEEGEY	JH HH IY JH IY
JHEEL	JH IY L
JHEELEN	JH HH IY L AH N
JHEELON	JH HH IY L AH N
JHELE	JH HH IY L
JHIJHAK	JH HH IH JH HH AH K
JHILLI	JH HH IH L IY
JHINOR	JH HH AY N AH R
JHIRAK	JH HH IH R AH K
JHOLI	JH HH AA L IY
JHOMPRI	JH HH AA M P R IY
JHONKAY	JH HH AO NG K EY IY
JHONKON	JH HH AO NG K AH N
JHOOLE	JH HH UW L
JHOOLON	JH HH UW L AH N
JHOOM	JH HH UW M
JHOOT	JH HH UW T
JHUGGI	JH HH AH JH IY
JHUKAO	JH HH Y UW K EY OW
JHULAS	JH HH Y UW L AH Z
JHUMKE	JH HH AH M K
JHUND	JH HH AH N D
JHUNJULAHAT	JH HH AH N JH UW L AH HH AH T
JHURRIYA	JH HH AH R IY AY AH
JIDOJAHAD	JH AH D AA JH AH HH AH D
JIGAR	JH IH G ER
JIHAAD	JH IH HH AH D
JIN	JH IH N
JINN	JH IH N
JIS	JH IH Z
JISM	JH IH Z AH M
JISS	JH IH S
JITNAY	JH IH T N EY IY
JITNEY	JH IH T N IY
JITNI	JH IH T N IY
JIYE	JH AY AY
JKHRANI	JH K HH R AE N IY
JMKHANH	JH M K AE N
JO	JH OW
JOB	JH AA B
JOB(2)	JH OW B
JOGGING	JH AA G IH NG
JOGGING(2)	JH AO G IH NG
JOGI	JH OW JH IY
JOHAR	JH AA AH R
JOHI	JH AA HH IY
JOHRI	JH AA R IY
JOINT	JH OY N T
JOIYA	JH OY AY AH
JOJOBA	HH OW HH OW B AH
JOKHON	JH AA K AH N
JOLAANI	JH AA L AH N IY
JOON	JH UW N
JOONA	JH UW N AH
JOQ	JH AA K
JOR	JH AO R
JORA	JH AO R AH
JORE	JH AO R
JOREN	JH AO R AH N
JORH	JH AO R
JORIYAN	JH AH R IY AY AH N
JOSH	JH AA SH
JOSSI	JH AA S IY
JOUNHI	JH AW N HH IY
JOYA	JH OY AH
JOYE	JH OY
JOYEN	JH OY AH N
JRT	JH EY AA R T
JUAY	JH UW W EY IY
JUBILEE	JH UW B AH L IY
JUDA	JH UW D AH
JUDAGHANA	JH UW D AE AH N AH
JUDGE	JH AH JH
JUDGON	JH AH JH AH N
JUDICIAL	JH UW D IH SH AH L
JUDICIARY	JH UW D IH SH IY EH R IY
JUG	JH AH G
JUICE	JH UW S
JULLUNDHRI	JH AH L AH N D HH R IY
JULOOS	JH UW L UW Z
JULY	JH UW L AY
JULY(2)	JH AH L AY
JUMERAT	JH UW M AH R AH T
JUMMA	JH AH M AH
JUNE	JH UW N
JUNEJO	JH UW N EY HH OW
JUNG	Y UH NG
JUNGI	JH AH N JH IY
JUNGJOO	JH AH N G UW
JUNGJUYANA	JH AH N G AH W AY AH N AH
JUNGLON	JH AH N G L AH N
JUNIOR	JH UW N Y ER
JUNOOBI	JH UW N AH B IY
JURM	JH AH R M
JURWAN	JH AH R W AH N
JUST	JH AH S T
JUST(2)	JH IH S T
JUSTICE	JH AH S T AH S
JUSTICE(2)	JH AH S T IH S
JUSTUJU	JH AH S T Y UW JH UW
K	K EY
K	K EY
K6590	K EY S IH K S F AY V N AY N Z IY R OW
KA	K AA
KAA	K AA
KAABIL	K AA B AH L
KAAF	K AA F
KAAFI	K AA F IY
KAAFOOR	K AA F OW AH R
KAAM	K AA M
KAANDHON	K AA N D HH AH N
KAAR	K EY AH R
KAAROBAR	K AA R AH B AH R
KAB	K AE B
KABADI	K AE B AH D IY
KABEER	K EY B IH R
KABHI	K AE B HH IY
KABOOTAR	K AH B UW T AH R
KACHE	K AE CH
KACHEHRI	K AE CH AH R IY
KACHI	K AE CH IY
KACHLA	K AE K L AH
KACHOKEY	K AH CH OW K IY
KACHORI	K AE CH AH R IY
KACHRA	K AE K R AH
KACHRE	K AE K R
KACHWA	K AE CH W AH
KACHWAY	K AE CH W EY IY
KACHWON	K AE CH W AH N
KADE	K EY D
KAFER	K EY F ER
KAFI	K AE F IY
KAGHAN	K AE AH N
KAGHAZ	K AE AH Z
KAGHAZAAT	K AE AH Z AH T
KAHA	K AE HH AH
KAHAF	K AE HH AH F
KAHAN	K AH HH AA N
KAHANI	K AE HH AH N IY
KAHIN	K AE HH AH N
KAHKASHAON	K AH K AE SH EY AH N
KAHNAY	K AE N EY IY
KAHO	K AE HH OW
KAI	K AY
KAISA	K EY S AH
KAISE	K EY Z
KAISI	K EY S IY
KAJOO	K AE JH UW
KAKLEN	K AE K L AH N
KAL	K AE L
KAL(2)	K EY EY EH L
KALA	K AE L AH
KALEEDI	K EY L AH D IY
KALEJI	K AE L AH JH IY
KALI	K AE L IY
KALRATHI	K AE L R AH TH IY
KALVANJI	K AE L V AE N JH IY
KAM	K AE M
KAMAHKA	K AE M AH K AH
KAMENGI	K AH M EH N JH IY
KAMIYAABI	K EY M IY AY AH B IY
KAMRAY	K AE M R EY IY
KAMRE	K EY M AH R
KAMRON	K AE M R AH N
KAMYAAB	K AE M AY AH B
KAMYAB	K AE M AY AH B
KAMYABIYON	K AE M AY AH B IY AY AH N
KAMZOR	K AE M Z AH R
KANDHALWI	K AE N D HH AE L W IY
KANGAROO	K AE NG G ER UW
KANGE	K AE N JH
KANGI	K AE N JH IY
KANJI	K AE N JH IY
KANJU	K AE N JH UW
KANOLA	K AE N AH L AH
KAR	K AA R
KARA	K EH R AH
KARACHI	K AA R AA CH IY
KARAEIN	K AE R IY AH N
KARAHI	K AE R AH HH IY
KARAI	K AE R EY
KARAM	K AE R AH M
KARAWAI	K AE R AH EY
KARAYA	K AE R EY AH
KARAYEN	K AE R EY AH N
KARAYON	K AE R EY AH N
KARDEY	K AA R D IY
KARDEYA	K AA R D EY AH
KARE	K AE R
KAREEBI	K AH R IY B IY
KAREEM	K ER IY M
KAREIN	K AH R IY N
KAREN	K EH R AH N
KAREY	K AE R IY
KARIYO	K AH R IY AY OW
KARKARDGI	K AA R K AA R JH IY
KARKHER	K AA R K AH R
KARNA	K AA R N AH
KARNAY	K AA R N EY IY
KARNE	K AA R N
KARNEY	K AA R N IY
KARNI	K AA R N IY
KARO	K AE R OW
KAROD	K AE R AH D
KAROFAR	K AE R AH F AH R
KARON	K EH R AH N
KARORRON	K AH R AO R AH N
KARTA	K AA R T AH
KARTE	K AA R T
KARTEY	K AA R T IY
KARTI	K AA R T IY
KARUN	K ER UW N
KARVAE	K AA R V IY
KARVI	K AA R V IY
KARWA	K AA R W AH
KARWAA	K AA R W AH
KARWAADI	K AA R W AH D IY
KARWAALI	K AA R W AH L IY
KARWAANA	K AA R W AH N AH
KARWAANEY	K AA R W AH N IY
KARWAANI	K AA R W AH N IY
KARWAI	K AA R W EY
KARWAIEN	K AA R W EY AH N
KARWAIYON	K AA R W EY AY AH N
KARWANAY	K AA R W AA N EY IY
KARWAO	K AA R W EY OW
KASEER	K EY Z IH R
KASHAF	K AE SH AH F
KASHIF	K AE SH AH F
KASHMIRI	K AE SH M IY R IY
KASMIRI	K AE Z M AH R IY
KASRAT	K AE Z R AH T
KATHA	K AE TH AH
KATHIN	K AE TH AH N
KAY	K EY
KAYI	K EY IY
KBHI	K B HH IY
KCHILE	K CH AY L
KE	K EH
KEE	K IY
KEECHAR	K IY CH AH R
KEEP	K IY P
KEERE	K IH R
KEERHA	K IH R AH
KEERON	K IH R AH N
KEH	K IY
KEHALWA	K AH HH AE L W AH
KEHKAHE	K EH K AH HH
KEHKASHAN	K EH K AH SH AH N
KEHNA	K EH N AH
KEIN	K IY N
KELULA	K AH L UW L AH
KERE	K IH R
KESEY	K S IY
KEVRRA	K EH V R AH
KEYA	K EY AH
KH	K EY
KH	K EY
KHA	K HH AA
KHAA	K HH AA
KHAAD	K HH AA D
KHAAK	K HH AA K
KHAAL	K HH EY AH L
KHAAM	K HH AA M
KHAANE	K HH AA N
KHAAS	K HH AA Z
KHAASI	K HH AA S IY
KHAATE	K HH EY EY T
KHABAR	K HH EY B AH R
KHABARON	K HH AE B AH R AH N
KHABRAIN	K HH AE B R EY N
KHACHA	K HH AE CH AH
KHACHI	K HH AE CH IY
KHADDAR	K HH AE D AH R
KHADD-O-KHAAL	K HH AE D OW K HH EY AH L
KHADI	K HH AE D IY
KHADIM	K HH AE D AH M
KHADSHA	K HH AE D SH AH
KHADSHEY	K HH AE D SH IY
KHAFGI	K HH AE F JH IY
KHAFIF	K HH AE F AH F
KHAFT	K HH AE F T
KHAGA	K HH AE G AH
KHAIL	K HH EY L
KHAILAY	K HH EY L EY IY
KHAILON	K HH EY L AH N
KHAILTAY	K HH EY L T EY IY
KHAIMAY	K HH EY M EY IY
KHAIR	K HH AE AH R
KHAIRS	K HH AE AH R Z
KHAIZ	K HH EY Z
KHAJOOREN	K HH AE JH AH R AH N
KHAKAN	K HH EY K AH N
KHALAL	K HH EY L AH L
KHALAYI	K HH AE L EY IY
KHALID	K AA L IH D
KHALID(2)	HH AA L IH D
KHALIFA	K AH L IY F AH
KHALIL	K AE L AH L
KHALIYE	K HH EY L IY AY
KHALQ	K HH AE L K
KHAM	K HH AE M
KHAMBE	K HH AE M
KHAMOSH	K HH AE M AH SH
KHAMOSHI	K HH AE M AH SH IY
KHAN	K AA N
KHANA	K HH AE N AH
KHANAZEER	K HH AE N AH Z IH R
KHANDAAN	K HH AE N D EY AH N
KHANE	K HH EY N
KHANGALNAY	K HH AE N G AE L N EY IY
KHANGI	K HH AE N JH IY
KHANJAR	K AA N JH AA R
KHANQAHOON	K HH AE N K AH UW N
KHANZADA	K HH AE N Z AH D AH
KHAO	K HH EY OW
KHAR	K HH AA R
KHARA	K HH AE R AH
KHARCH	K HH AA R K
KHARE	K HH AE R
KHAREED	K HH AH R IY D
KHAREEDAY	K HH AH R IY D EY IY
KHAREEDI	K HH AH R IY D IY
KHARIYAT	K HH AH R IY AY AH T
KHARJA	K HH AA R JH AH
KHAROSH	K HH AE R AH SH
KHARRAB	K HH AE R AH B
KHARRAY	K HH AE R EY IY
KHARYAT	K HH AE R AY AH T
KHASARE	K HH AE S AH R
KHASAY	K HH AE S EY IY
KHASHOONAT	K HH AH SH UW N AH T
KHASKHAS	K HH AE S AH Z
KHASOOT	K HH AH S UW T
KHATAM	K HH AE T AH M
KHATIR	K HH AE T AH R
KHATME	K HH AE T M
KHATOON	K HH AH T UW N
KHAUF	K HH AO F
KHAUFON	K HH AO F AH N
KHAUN	K HH AO N
KHAWAAS	K HH AO AH Z
KHAWAND	K HH AO AH N D
KHAWANDGI	K HH AO AE N JH IY
KHAWARI	K HH AO AH R IY
KHAWASTGAH	K HH AO AE S T G AH
KHAWATEEN	K HH AO EY T IY AH N
KHAWESH	K HH AO AH SH
KHAYA	K HH EY AH
KHAYAL	K HH EY AH L
KHAYAM	K HH EY AH M
KHAYAT	K HH EY AH T
KHAYEN	K HH EY AH N
KHAYRIAT	K HH EY R IY AH T
KHAZA	K HH AE Z AH
KHAZAN	K HH EY Z AH N
KHAZANA	K HH AE Z AH N AH
KHDAYI	K HH D EY IY
KHEER	K HH IY AH R
KHEERA	K HH IH R AH
KHEH	K HH IY
KHEH	K HH IY
KHEL	K HH EH L
KHELAIN	K HH AH L EY N
KHELEDRA	K HH AH L EH D R AH
KHELNE	K HH EH L N
KHELNI	K HH EH L N IY
KHENCHI	K HH EH NG K IY
KHEY	K HH IY IY
KHICH	K HH IH CH
KHICHRI	K HH IH K R IY
KHIDMAAT	K HH IH D M AH T
KHILAAF	K HH IH L AH F
KHILAF	K HH IH L AH F
KHILARI	K HH IH L AH R IY
KHILARIYON	K HH IH L AH R IY AY AH N
KHILDI	K HH IH L D IY
KHILJI	K HH IH L JH IY
KHILKHILA	K HH IH L K AH L AH
KHILOY	K HH IH L OW IY
KHILVAD	K HH IH L V AH D
KHIRKI	K HH AH R K IY
KHISAAL	K HH IH S EY AH L
KHISAK	K HH IH S AH K
KHISHA	K HH IH SH AH
KHIST	K HH IH S T
KHIZAA	K HH IH Z AH
KHIZER	K HH AY Z AH R
KHLWAYIN	K HH L W EY AH N
KHO	K HH OW
KHOB	K HH AA B
KHOBSORAT	K HH AA B S AH R AH T
KHOD	K HH AA D
KHODSOZI	K HH AA D S AH Z IY
KHOFNAAK	K HH AA F N AH K
KHOJ	K HH AA JH
KHOKHALA	K HH AA K AH L AH
KHOKLE	K HH AA K AH L
KHOKLI	K HH AA K L IY
KHOL	K HH AA L
KHOLE	K HH OW L
KHOLEN	K HH OW L AH N
KHOLNE	K HH OW L N
KHOLO	K HH AA L OW
KHONE	K HH OW N
KHOOFIA	K HH UW F IY AH
KHOON	K HH UW N
KHOOSKHABRI	K HH UW S AE B R IY
KHORAAK	K HH AO R AH K
KHOST	K OW S T
KHOYA	K HH OY AH
KHOYE	K HH OY
KHUAHAN	K HH Y UW AH AH N
KHUAN	K HH Y UW AH N
KHUBBE	K HH AH B
KHUD	K HH AH D
KHUDA	K HH Y UW D AH
KHUDAON	K HH Y UW D EY AH N
KHUDKUSHION	K HH AH D K AH SH AH N
KHUDRO	K HH AH D R OW
KHUDSER	K HH AH D Z AH R
KHUGHAR	K HH AH AH R
KHUI	K HH UW
KHUJLI	K HH AH JH L IY
KHUJOOR	K HH Y UW JH OW AH R
KHUL	K HH AH L
KHULE	K HH Y UW L
KHULEIN	K HH Y UW L IY N
KHULEY	K HH Y UW L IY
KHULNE	K HH AH L N
KHULOOS	K HH Y UW L UW Z
KHUMAAR	K HH Y UW M EY AH R
KHUMBIYON	K HH AH M B IY AY AH N
KHURSHEED	K HH AH R SH IY D
KHUSBOO	K HH AH Z UW
KHUSBUYEIN	K HH AH Z Y UW AY IY N
KHUSH	K HH AH SH
KHUSHBOON	K HH AH SH B UW N
KHUSHGAWAR	K HH AH SH G AH AH R
KHUSHI	K HH AH SH IY
KHUSHIYAN	K HH AH SH IY AY AH N
KHUSHNOODI	K HH AH SH N AH D IY
KHUSHU	K HH AH SH UW
KHUSOOSAN	K HH Y UW S UW Z AH N
KHUSOOSI	K HH Y UW S AH S IY
KHUSRON	K HH AH Z R AH N
KHUSSE	K HH AH S
KHUZAR	K HH Y UW Z AH R
KHUZU	K HH Y UW Z UW
KHWA	K W AA
KHWAAR	K W EY AH R
KHWABEEDA	K W EY B IY D AH
KHWAHISH	K W AA AH SH
KHWAHISHMAND	K W AH HH IH SH M AH N D
KHWAJA	K W AA JH AH
KHWARJA	K W AO R JH AH
KHWARZIMI	K W AO R Z AH M IY
KI	K IY
KIA	K IY ER
KICH	K IH CH
KIDNAP	K IH D N AE P
KIDS	K IH D Z
KIFALAT	K IH F AH L AH T
KIFAYAT	K IH F EY AH T
KIJIYE	K IH JH IY AY
KILO	K IH L OW
KILOMETERE	K IH L AH M IY T AH R
KIMOTHRAPI	K AH M AA TH R AH P IY
KINARA	K IH N AH R AH
KINARAY	K IH N AH R EY
KINDLY	K AY N D L IY
KINDS	K AY N D Z
KINDS(2)	K AY N Z
KINGDOM	K IH NG D AH M
KINRADE	K IH N R EY D
KIRDAAR	K AH R D EY AH R
KIRDAR	K AH R D AH R
KIS	K IH S
KISAM	K IH S AH M
KISI	K IH S IY
KISSA	K IH S AH
KISSE	K IH S
KISSI	K IH S IY
KITAAB	K IH T AH B
KITAABEN	K IH T AH AH B IY AH N
KITABCHA	K AH T AE B CH AH
KITNA	K IH T N AH
KITNAY	K IH T N EY IY
KIYA	K AY AY AH
KIYE	K AY AY
KIZULFON	K AH Z AH L F AH N
KNOW	N OW
KO	K OW
KOCHIGARH	K AA CH AH G AH R
KOCHRIKO	K AA K R AH K OW
KOFEN	K OW F AH N
KOHASTAN	K AH HH AE S T AH N
KOI	K OY
KOIL	K OY L
KOILE	K OW AH L
KOKH	K AA K
KOLESHEN	K AA L AH SH AH N
KOLSERY	K AA L Z AH R IY
KON	K AA N
KONEEN	K OW N IY AH N
KONSI	K AA N S IY
KOOCHA	K UW CH AH
KOOCHE	K UW CH
KOOFI	K UW F IY
KOOYEN	K UW AY AH N
KOREAN	K AO R IY AH N
KORH	K AO R
KORI	K AO R IY
KORIYAN	K AH R IY AY AH N
KORMA	K AO R M AH
KOSHA	K AA SH AH
KOSHISH	K AA SH AH SH
KOSHISHEN	K AA SH AH SH AH N
KOSHISHON	K AA SH AH SH AH N
KOSON	K AA S AH N
KOTAHI	K AA T AH HH IY
KOTHEY	K AA TH IY
KOTHI	K AA TH IY
KOTHIYON	K AH TH IY AY AH N
KOTHRI	K AA TH R IY
KOTHYAN	K AA TH AY AH N
KR	K EY R
KRAON	K R EY AH N
KRNA	K R N AA
KRNE	K R N
KRNI	K R N IY
KRTA	K R T AA
KRTE	K R T
KRTI	K R T IY
KTABCHE	K T AE B CH
KUB	K AH B
KUCH	K AH CH
KUCHA	K AH CH AH
KUCHLE	K AH K L
KUFFAR	K AH F AH R
KUFR	K AH F R
KUH	K UW
KULSOOM	K AH L S UW M
KUM	K AH M
KUN	K AH N
KUNR	K AH N R
KUNWAN	K AH N W AH N
KURHNE	K AH R N
KYA	K AY AH
KYOLRI	K AY OW L R IY
KYUN	K AY AH N
KYUNKAY	K AY AH NG K EY IY
KYUN-KE	K AY AH N K EH
L	EH L
L	EH L
LA	L AA
LAAD	L AA D
LAAKH	L AA K
LAAL	L EY AH L
LAALCHI	L AA L CH IY
LAAM	L AA M
LAATHI	L AA TH IY
LAAYE	L AA AY
LAB	L AE B
LABALAB	L AE B AH L AE B
LABATTAH	L AH B AE T AH
LABING	L AE B IH NG
LABORATORY	L AE B R AH T AO R IY
LABOUR	L EY B ER
LACHAK	L AE CH AH K
LACHAR	L AE CH AH R
LADEENIYAT	L EY D AH N IY AY AH T
LADKAWALA	L AE D K AO AH L AH
LADLEY	L AE D L IY
LADY	L EY D IY
LAEIN	L IY AH N
LAFZ	L AE F Z
LAFZI	L AE F Z IY
LAFZON	L AE F Z AH N
LAGA	L AE G AH
LAGAATA	L AE G AH T AH
LAGAI	L AE G EY
LAGANA	L AA G AE N AH
LAGANE	L AH G EY N
LAGAO	L AE G EY OW
LAGAT	L AE G AH T
LAGAYA	L AE G EY AH
LAGAYE	L AE G EY
LAGAYEN	L AE G AH Y EH N
LAGE	L EY JH
LAGEN	L AE G AH N
LAGEY	L EY JH IY
LAGHARI	L AE AH R IY
LAGHZISH	L AE Z AH SH
LAGI	L AE JH IY
LAHAQ	L AE HH AH K
LAHO	L AE HH OW
LAHORE	L AA HH AO R
LAHORI	L AE HH AH R IY
LAHORIYAAT	L AE HH AH R IY AY AH T
LAHU	L AE HH UW
LAI	L AY
LAIHA	L EY HH AH
LAIK	L EY K
LAILA	L EY L AH
LAIS	L EY Z
LAKAR	L EY K ER
LAKARWAALA	L AH K AA R W AH L AH
LAKARWAARA	L AH K AA R W AH R AH
LAKARWARA	L AH K AA R W AH R AH
LAKDAWALA	L AE K D AO AH L AH
LAKH	L AE K
LAKHA	L AE K AH
LAKHON	L AE K AH N
LAKHT	L AE K T
LAMHE	L AE M HH
LAMHON	L AE M HH AH N
LAMP	L AE M P
LAND	L AE N D
LANDSCAPE	L AE N D S K EY P
LANDSCAPE(2)	L AE N S K EY P
LANDSLIDING	L AE N D S L AY D IH NG
LANG	L AE NG
LANGA	L AE N G AH
LANGAR	L AE N G AH R
LANGRI	L AE N G R IY
LANGUAGE	L AE NG G W AH JH
LANGUAGE(2)	L AE NG G W IH JH
LAO	L AW
LAQAB	L AE K AH B
LARA	L AA R AH
LARAI	L AE R EY
LARAIB	L AH R EY B
LAREN	L AE R AH N
LARKA	L AA R K AH
LARKHARA	L AA R K AH R AH
LARKIYAN	L AA R K IY AY AH N
LASER	L EY Z ER
LASHAIN	L AE SH AH IH N
LASHKAR	L AE SH AH R
LASHON	L AE SH AO N
LAST	L AE S T
LATEEFEY	L EY T IY F IY
LATHIYAN	L AH TH IY AY AH N
LAUBALI	L AO B AH L IY
LAUHON	L AO HH AH N
LAUN	L AO N
LAUNCHING	L AO N CH IH NG
LAUNGE	L AO N JH
LAUS	L EY AH S
LAUT	L AO T
LAWN	L AO N
LAY	L EY
LAYA	L EY AH
LAYE	L EY
LAYEN	L EY AH N
LAYI	L EY IY
LAYUNFIK	L EY AH N F AH K
LAZAT	L AE Z AH T
LAZING	L EY Z IH NG
LCATION	L K EY SH AH N
LE	L AH
LEADER	L IY D ER
LEADS	L IY D Z
LEAK	L IY K
LEARN	L ER N
LEARNING	L ER N IH NG
LEATHER	L EH DH ER
LEAYA	L IY AY AH
LEFT	L EH F T
LEGA	L EH G AH
LEGEND	L EH JH AH N D
LEGENDARY	L EH JH AH N D EH R IY
LEHAZA	L EH HH AH Z AH
LEHJA	L EH JH AH
LEHJEY	L EH JH IY
LEHREN	L EH R AH N
LEIN	L IY N
LEKIN	L EH K AH N
LEN	L EH N
LENA	L IY N AH
LENE	L IY N
LENGTH	L EH NG K TH
LENGTH(2)	L EH NG TH
LESSON	L EH S AH N
LESSONS	L EH S AH N Z
LETA	L EH T AH
LETE	L IY T
LETEY	L IY T IY
LETI	L EH T IY
LETS	L EH T S
LETTER	L EH T ER
LETTERS	L EH T ER Z
LEWA	L UW AH
LEYA	L EY AH
LEYNA	L EY N AH
LFZYAT	L F Z AY AH T
LGHW	EH L JH IY EY CH W
LI	L IY
LIA	L IY AH
LIBAAS	L IH B AH Z
LIBRARY	L AY B R EH R IY
LIBRERIAN	L IH B R IY R IY AH N
LIEN	L IY N
LIEUTENANT	L UW T EH N AH N T
LIHAAZ	L IH HH AH Z
LIHAZA	L IH HH AH Z AH
LIKE	L AY K
LIKELY	L AY K L IY
LIKH	L IH K
LIKHA	L IH K AH
LIKHAIN	L IH K EY N
LIKHE	L IH K
LIKHI	L IH K IY
LIKHNAY	L IH K N EY IY
LIKHO	L IH K OW
LIKHTE	L IH K T
LIKHUN	L IH K AH N
LIKHWA	L IH K W AH
LIMUN	L IH M AH N
LINE	L AY N
LISTEN	L IH S AH N
LISTENING	L IH S AH N IH NG
LISTENING(2)	L IH S N IH NG
LITCHI	L IH CH IY
LITERATURE	L IH T ER AH CH ER
LITHEREY	L AH TH IY R IY
LITTLE	L IH T AH L
LIVE	L AY V
LIVE(2)	L IH V
LIVESTOCK	L AY V S T AA K
LIYA	L AY AY AH
LIYAQAT	L AY AY AH K AH T
LIYE	L AY AY
LIYW	L AY AH W
LO	L OW
LOAD	L OW D
LOADSHEDING	L OW D SH EH D IH NG
LOCK	L AA K
LOG	L AO G
LOGO	L OW G OW
LOGON	L AA G AO N
LOHA	L AA HH AH
LOHAN	L AA AH N
LOHAR	L AA AH R
LOHE	L AA HH
LOK	L AA K
LOLLY	L AA L IY
LOMRI	L AA M R IY
LONGI	L AA N JH IY
LOOK	L UH K
LOOKS	L UH K S
LOOT	L UW T
LOT	L AA T
LOT(2)	L AO T
LOTHRA	L AA TH R AH
LOTION	L OW SH AH N
LOUD	L AW D
LOUIS	L UW IH S
LOUIS(2)	L UW IY
LOVE	L AH V
LOWER	L OW ER
LOWNG	L OW NG
LQUID	L K W IH D
LUCK	L AH K
LUDHIYANVI	L AH D HH IY AY AE N V IY
LUGHAT	L AH G HH AE T
LUGHWI	L AH W IY
LUMAR	L UW M AH R
LUN	L AH N
LUND	L AH N D
LURHAQ	L AH R AH K
LUXURY	L AH G ZH ER IY
M	EH M
M	EH M
MA	M AA
MAA	M AA
MAAB	M AA B
MAACHIS	M AA CH AH S
MAAD	M AA D
MAADHU	M AA D HH UW
MAAF	M AA F
MAAKHIZ	M AA K AH Z
MAAL	M EY AH L
MAAM	M AH M
MAAMLAY	M AA M L EY IY
MAAN	M EY AH N
MAANEY	M AA N IY
MAANG	M AA NG
MAANI	M AA N IY
MAAR	M EY AH R
MAARAZ	M AA R AH Z
MAASHOOQ	M AA SH AH K
MAATHEY	M AA TH IY
MAAVZON	M AA V Z AH N
MAAZI	M AA Z IY
MAAZRAT	M AA Z R AH T
MABAIN	M AH B EY N
MABZOOL	M AE B Z UW L
MACHA	M AE CH AH
MACHANE	M AH CH EY N
MACHAR	M AE CH AH R
MACHERON	M AE CH AH R AH N
MACHHI	M AE CH IY
MACHINE	M AH SH IY N
MACHINERY	M AH SH IY N ER IY
MACHINERY(2)	M AH SH IY N R IY
MACHLI	M AE K L IY
MACHLIYAN	M AE K L IY AY AH N
MACHOLI	M AE CH AH L IY
MAD	M AE D
MADAA	M AE D AH
MADAD	M AE D AH D
MADAHON	M AE D AH HH AH N
MADAM	M AE D AH M
MADAT	M AE D AH T
MADDAH	M AE D AH
MADE	M EY D
MADFAN	M AE D F AE N
MADFOON	M AE D F UW N
MADGHAM	M AE JH HH AH M
MADHAM	M AE D HH AE M
MADHAR	M AE D AH R
MADHON	M AE D HH AH N
MADHOSH	M AE D HH AH SH
MAD-MUQABIL	M AE D M AH K AH B AH L
MADOO	M AE D UW
MADOON	M AH D UW N
MADRASSA	M AE D R AE S AH
MADRASSON	M AE D R AE S AH N
MADZOOB	M AE D Z UW B
MAED	M AA D
MAEESHAT	M IY AH SH AH T
MAFAAD	M AE F AH D
MAFHOOM	M AE F UW M
MAFIA	M AA F IY AH
MAFLOOJ	M AE F L UW JH
MAFQOOD	M AE F UW D
MAFROOZAAT	M AE F R UW Z AH T
MAGAR	M AE G ER
MAGARMACH	M AH G AA R M AH CH
MAGAZINE	M AE G AH Z IY N
MAGHAZ	M AE AH Z
MAGHFIRAT	M AE F AH R AH T
MAGHFOOR	M AE F OW AH R
MAGHFY	M AE F IY
MAGHLOOB	M AH L UW B
MAGHROUR	M AE R AH R
MAGSI	M AE G S IY
MAH	M AA
MAHAULIYAT	M AE HH AH L IY AY AH T
MAHEENE	M AH HH IY N
MAHENA	M AE HH AH N AH
MAHIREEN	M AH HH AY R IY AH N
MAHJOOR	M AE JH OW AH R
MAHLON	M EY L AO N
MAHOL	M AE HH AH L
MAHROOM	M AH R UW M
MAHROON	M AH R UW N
MAHSWARA	M AE S W AH R AH
MAHWAAR	M AE W EY AH R
MAI	M AY
MAIDAN	M EY D AH N
MAIDE	M EY D
MAIL	M EY L
MAIN	M EY N
MAIYAT	M EY AY AH T
MAIZBAN	M EY Z AH N
MAJBOOR	M AE JH OW AH R
MAJEED	M EY JH IY D
MAJHAY	M AE JH HH EY IY
MAJLE	M EY JH AH L
MAJLIS	M AE JH L AH S
MAJMOA	M AE JH M OW AH
MAJMOAY	M AE JH M OW IY
MAJMOI	M AE JH M OY
MAJMUON	M AE JH M Y UW AH N
MAJOR	M EY JH ER
MAJROOH	M AE JH R UW
MAKE	M EY K
MAKES	M EY K S
MAKHDOOM	M AE K D UW M
MAKHDOOSH	M AE K D UW SH
MAKHHAN	M AE K AH N
MAKHION	M AE K IY AH N
MAKHIYAN	M AE K IY AY AH N
MAKHLOOQ	M AE K L AH K
MAKHOOZ	M AE K UW Z
MAKHRAJ	M AE K R AH JH
MAKHSOOS	M AE K S UW Z
MAKING	M EY K IH NG
MAKORON	M EY K ER AO N
MALAYSIA	M AH L EY ZH AH
MALAYSIAN	M AH L EY ZH AH N
MALBOOSAAT	M AE L B UW S AH T
MALDAAR	M AE L D EY AH R
MALE	M EY L
MALERIA	M AH L IY R IY AH
MALFOOZAT	M AE L F UW Z AH T
MALGHOBAH	M AE L G AA B AH
MALHOOT	M AE L HH UW T
MALIK	M AE L IH K
MALIKHOLIA	M AH L IH K OW L Y AH
MALOOM	M AH L UW M
MALOOMAAT	M AH L UW M AH T
MALOOMAT	M AH L UW M AH T
MALZOOM	M AE L Z UW M
MAMLAAT	M AE M L AH T
MAMNOO	M AE M N UW
MAMOOLI	M AH M UW L IY
MAN	M AE N
MANAGEMENT	M AE N AH JH M AH N T
MANAGEMENT(2)	M AE N IH JH M AH N T
MANAGER	M AE N AH JH ER
MANAGER(2)	M AE N IH JH ER
MANAGING	M AE N AH JH IH NG
MANAGMENT	M AE N EY JH M AH N T
MANASH	M AE N AE SH
MAND	M AE N D
MANDIYON	M AE N D AY IY AO N
MANDOBEEN	M AE N D UW B IY AH N
MANE	M EY N
MANFI	M AE N F IY
MANFIYAT	M AE N F IY AY AH T
MANGAL	M AE N G AE L
MANGNE	M AE N
MANGNI	M AE N G N IY
MANGWA	M AE N G W AH
MANHOOS	M AE N HH UW Z
MANJE	M AE N JH
MANJHDAR	M AE N JH HH D AH R
MANJI	M AE N JH IY
MANNUAL	M AE N Y AH W AH
MANOS	M EY N OW Z
MANSHOOR	M AE N SH UW ER
MANSOOBE	M AE N S UW B
MANSOOKH	M AE N S AH K
MANSOOKHI	M AE N S UH K IY
MANUFACTURER	M AE N Y AH F AE K CH ER ER
MANUFACTURERS	M AE N Y AH F AE K CH ER ER Z
MANWA	M AE N W AH
MANWIYAT	M AE N W IY AY AH T
MANY	M EH N IY
MANZAR	M AE N Z AH R
MANZOOM	M AE N Z UW M
MANZOOR	M AE N Z OW AH R
MANZOOR	M AE N Z OW AH R
MAO	M AW
MAOOD	M EY UW D
MAQAB	M AE K AH B
MAQAM	M AE K AH M
MAQBOOZA	M AE K B UW Z AH
MAQOOL	M AH K UW L
MAQROOZ	M AE K R UW Z
MAQSAD	M AE K S AH D
MAQSOOD	M AE K S UW D
MAR	M AA R
MARA-AAT	M AA R AH AA T
MARATHON	M EH R AH TH AA N
MARCH	M AA R CH
MARDANGNI	M AA R D AE N G N IY
MARDON	M AA R D AH N
MARE	M EH R
MAREEZON	M AH R IY Z AH N
MARGHAZAR	M AA R AH Z AH R
MARGHOOB	M AH R UW B
MARHOOM	M AH R UW M
MARHOON	M AH R UW N
MARKAZI	M AA R K AH Z IY
MARLAH	M AA R L AH
MARNE	M AA R N
MAROZI	M AE R AH Z IY
MARRAH	M AE R AH
MARRI	M AE R IY
MARRIAGE	M EH R IH JH
MARSHAL	M AA R SH AH L
MARSIYE	M AA R S IY AY
MARTABA	M AA R T AH B AH
MARZ	M AA R Z
MARZI	M AA R Z IY
MASAIL	M AA Z EY L
MASALA	M AE S AH L AH
MASHAEKHE	M AH SH IY K
MASHAGHIL	M AE SH AH AH L
MASHAR	M AE SH ER
MASHE	M AE SH
MASHGALA	M AE SH G AE L AH
MASHHOOR	M AE SH HH OW ER
MASHIYAT	M AH SH IY AY AH T
MASHOOOR	M AE SH UW AH R
MASHQ	M AE SH
MASHQEN	M AE SH AH N
MASHRIQ	M AE SH R AH K
MASHROOBAT	M AE SH R UW B AH T
MASHROOD	M AE SH R UW D
MASHWARA	M AE SH W AH R AH
MASJID	M AE Z AH D
MASKHARE	M AE S K HH EH R
MASLA	M AE Z L AH
MASLAN	M AE Z L AH N
MASNOAAT	M AE Z N OW AH T
MASNOOI	M AE Z N UW IY
MASOOM	M AH S UW M
MASOORON	M AE S AH R AH N
MASQ	M AE S
MASROOF	M AA Z R UW F
MASROOFIYAT	M AE Z R AH F IY AY AH T
MAST	M AE S T
MAT	M AE T
MATBUA	M AE T B Y UW AH
MATCH	M AE CH
MATCHES	M AE CH AH Z
MATCHES(2)	M AE CH IH Z
MATCHON	M AE CH AO N
MATHA	M AE TH AH
MATLAB	M AE T L AE B
MATLOOBA	M AE T L UW B AH
MATURE	M AH CH UH R
MATURE(2)	M AH T Y UH R
MAUDBANA	M AO D AH N AH
MAUHLAT	M AO L AH T
MAUJIL	M AO JH AH L
MAUJOOD	M AH JH UW D
MAULA	M AO L AH
MAUQA	M AO K AH
MAUQEY	M AO K IY
MAUQON	M AO K AH N
MAUSAM	M AO S AH M
MAUSAR	M EY AH S AH R
MAUSHRE	M AO SH R
MAUT	M AO T
MAUTAL	M EY Y UW T AH L
MAUZIZ	M AO Z AH Z
MAWAD	M AO AH D
MAWALSLATI	M AO AE L S L AH T IY
MAWESHI	M AO AH SH IY
MAY	M EY
MAYANAT	M EY AH N AH T
MAYOOB	M EY UW B
MAYOOS	M EY UW Z
MAYOR	M EY ER
MAYYAD	M EY AY AH D
MAYYARI	M EY AY AH R IY
MAYYAT	M EY AY AH T
MAYYATON	M EY IY AH T AH N
MAZAAQ	M AE Z AH K
MAZAKRAAT	M AH Z AE K R AH T
MAZARAEEN	M AH Z AE R IY AH N
MAZAYEKA	M AH Z EY AH K AH
MAZBOOT	M AE Z UW T
MAZDA	M AA Z D AH
MAZDA(2)	M AE Z D AH
MAZDOORON	M AE Z D AH R AH N
MAZE	M EY Z
MAZEDAAR	M AH Z EH D EY AH R
MAZEED	M EY Z D
MAZHAB	M AE Z HH AH B
MAZHABI	M AE Z HH AH B IY
MAZHAQ	M AE Z HH AH K
MAZHAR	M AE Z AH R
MAZLAAM	M AE Z L AH M
MAZMOON	M AE Z M UW N
MAZOORIYON	M AE Z AH R IY AY AH N
MAZROB	M AE Z R AH B
ME	M IY
MEAN	M IY N
MEANDI	M IY N D IY
MEANS	M IY N Z
MEDIA	M IY D IY AH
MEDICAL	M EH D AH K AH L
MEDICAL(2)	M EH D IH K AH L
MEDICINE	M EH D AH S AH N
MEECHO	M IY CH OW
MEEL	M IY L
MEEM	M IY M
MEERA	M IH R AH
MEERAN	M IH R AH N
MEERTHI	M IH R TH IY
MEET	M IY T
MEETAIYAN	M IY T EY AY AH N
MEETHAY	M IY T HH EY
MEETHI	M IY TH IY
MEETING	M IY T IH NG
MEGA	M EH G AH
MEHANGA	M AH HH AE N G AH
MEHANGAI	M AH HH AE N G EY
MEHARBANI	M AH HH AA R B AH N IY
MEHARBANIYON	M AH HH AA R B AH N IY AY AH N
MEHAZ	M EH HH AH Z
MEHBOOB	M AH B UW B
MEHBOOBA	M AH B UW B AH
MEHDOOD	M AH D UW D
MEHFIL	M EH F AH L
MEHFOOZ	M AH F UW Z
MEHLOOL	M AH L UW L
MEHMAN	M EH M AH N
MEHNAT	M EH N AH T
MEHRAN	M EH R AH N
MEHSOOS	M AH S UW Z
MEHWAR	M EH W AH R
MEHWISH	M EH W AH SH
MEHWIYAT	M EH W IY AY AH T
MEHZOOZ	M AH Z UW Z
MEIN	M IY N
MELA	M EH L AH
MELAY	M EH L EY IY
MEMBER	M EH M B ER
MEMON	M EH M AH N
MEMORIAL	M AH M AO R IY AH L
MENDHA	M EH N D HH AH
MENE	M IY N
MENGAL	M EH N G AE L
MEOW	M IY AW
MERA	M EH R AH
MERAY	M EH R EY IY
MERBAANI	M AH R B AH N IY
MERCHANT	M ER CH AH N T
MERE	M IH R
MEREY	M IH ER IY
MERI	M EH R IY
MERIT	M EH R AH T
MESSAGE	M EH S AH JH
MESSAGE(2)	M EH S IH JH
MET	M EH T
METHI	M EH TH IY
METHODS	M EH TH AH D Z
METHYL	M EH TH AH L
METTHA	M EH T TH AH
MEVA	M EH V AH
MEWATI	M Y UW AH T IY
MEZEN	M IY Z AH N
MG	EH M G
MHMANAN	M HH M AE N AH N
MIAN	M AY AH N
MICROWAVE	M AY K R AH W EY V
MIDDLE	M IH D AH L
MIDNIGHT	M IH D N AY T
MIKHAYL	M IH K EY L
MIL	M IH L
MILA	M AY L AH
MILAU	M IH L AH
MILEIN	M AY L IH N
MILEY	M AY L IY
MILI	M IH L IY
MILLAT	M IH L AH T
MILLI	M IH L IY
MILLION	M IH L Y AH N
MILLIYA	M IH L IY AY AH
MILNAY	M IH L N EY IY
MILNE	M IH L N
MILNEY	M IH L N IY
MILSWEY	M IH L S W IY
MILTA	M IH L T AH
MILTI	M IH L T IY
MILUN	M IH L AH N
MINDED	M AY N D AH D
MINDED(2)	M AY N D IH D
MINT	M IH N T
MINUTE	M IH N AH T
MINUTE(2)	M AY N UW T
MINUTE(3)	M AY N Y UW T
MIQDAAR	M IH K D EY AH R
MIRCH	M AH R CH
MIRCHE	M AH R CH
MIRCHON	M AH R CH AH N
MIRZA	M ER Z AH
MISAAL	M AH S EY AH L
MISDAAQ	M IH S D AA K
MISS	M IH S
MISSILE	M IH S AH L
MITHAN	M IH TH AH N
MITTEN	M IH T AH N
MITTI	M IH T IY
MIZAAJ	M IH Z AH JH
MIZAH	M IH Z AH
MIZGAN	M IH Z AH N
MKHALFON	M K AE L F AH N
MLARIA	M L AE R IY AH
MNAFAON	M N AE F EY AH N
MNDRI	M N D R IY
MOAJAZAAT	M OW JH AH Z AH T
MOAJEZAE	M OW JH AH Z IY
MOAJOON	M OW JH UW N
MOAKHAR	M OW K AH R
MOAMMA	M OW M AH
MOASAR	M OW Z AH R
MOBILE	M OW B AH L
MOCHI	M AA CH IY
MODEL	M AA D AH L
MODELING	M AA D AH L IH NG
MODELING(2)	M AA D L IH NG
MOEED	M OW AH T
MOHABBAT	M AH HH AE B AH T
MOHAN	M OW HH AA N
MOHARRIR	M AH HH AE R AH R
MOHEEB	M AH HH IY B
MOHOOM	M AH HH UW M
MOHQIQEEN	M AA HH K IH K IY AH N
MOHSIN	M AA S AH N
MOHSINA	M AA S AH N AH
MOHTAAJON	M AA T AH JH AH N
MOHTARMA	M AH T AA R M AH
MOISTERIZER	M OY S T ER AY Z ER
MOISTURIZING	M OY S CH ER AY Z IH NG
MOJAB	M AA JH AH B
MOJOOD	M AH JH UW D
MOJOODA	M AH JH UW D AH
MOJOODAH	M AH JH UW D AH
MOJZAN	M AA JH Z AH N
MOKHAR	M AA K AH R
MOLANA	M AA L AH N AH
MOLVI	M OW L V IY
MOMAR	M AA M ER
MOMID	M AA M AH D
MOMIN	M AA M IH N
MOOCHEN	M UW CH AH N
MOOCHON	M UW CH AH N
MOOD	M UW D
MOODHI	M UW D HH IY
MOON	M UW N
MOONA	M UW N AH
MOONG	M UW NG
MOONUS	M UW N AH S
MOOZI	M UW Z IY
MORAK	M AO R AH K
MORCHAY	M AO R CH EY IY
MORDALZAM	M AO R D AE L Z AH M
MORE	M AO R
MORH	M AO R
MORKHIN	M AO R K AH N
MOROOSI	M AH R UW S IY
MOSEEQI	M OW S AH K IY
MOSLADHAR	M AA Z L AH D AH R
MOSMIYAT	M AA Z M IY AY AH T
MOSOOL	M AH S UW L
MOSTLY	M OW S T L IY
MOSTLY(2)	M OW S L IY
MOTEM	M AA T AH M
MOTION	M OW SH AH N
MOTORCYCLE	M OW T ER S AY K AH L
MOUF	M AW F
MOUNT	M AW N T
MOUT	M AW T
MOUTH	M AW TH
MOVE	M UW V
MOVEABLE	M UW V AH B AH L
MOVEMENT	M UW V M AH N T
MOVIE	M UW V IY
MOWAQEY	M OW AH K IY
MOZA	M OW Z AH
MOZOOAAT	M AA Z UW AH T
MOZOON	M AH Z UW N
MOZOONIYAT	M AA Z AH N IY AY AH T
MOZU	M OW Z UW
MP	EH M P
MRGHBANI	M R B AE N IY
MRS	M IH S IH Z
MTAADID	M T AA D AH D
MTHAL	M TH AE L
MTHRANI	M TH R AE N IY
MUA	M Y UW AH
MUAHIDAY	M Y UW AH HH IH D EY IY
MUAINA	M Y UW EY N AH
MUALIJ	M Y UW AH L AH JH
MUALIM	M Y UW AH L AH M
MUALJA	M Y UW AE L JH AH
MUALJE	M Y UW AH L JH
MUANIDANA	M Y UW AH N IH D AH N AH
MUAQQAF	M Y UW AE K AH F
MUAQQAR	M Y UW AE K AH R
MUARIFAT	M Y UW AE R AH F AH T
MUARKHA	M Y UW AA R K AH
MUASH	M Y UW AH SH
MUASHIAAT	M Y UW AE SH IY AH T
MUASIR	M Y UW AH S AH R
MUAVZA	M Y UW AE V Z AH
MUAWIN	M Y UW AH AH N
MUAZ	M Y UW AH Z
MUAZIZEEN	M Y UW AH Z AY Z IY AH N
MUBADLA	M Y UW B AE D L AH
MUBALIGHEEN	M Y UW B AH L AY IY AH N
MUBARAK	M UW B AA R IH K
MUBARAK(2)	M Y UW B AA R IH K
MUBASHIR	M Y UW B AH SH AH R
MUBEEN	M Y UW B IY AH N
MUBHAM	M AH B HH AH M
MUBLIGH	M AH B L IY
MUBNI	M AH B N IY
MUBTALA	M AH B T AH L AH
MUCH	M AH CH
MUDAFAT	M AH D AH F AE T
MUDAIYAN	M Y UW D EY AY AH N
MUDAKHLAT	M Y UW D AE K L AH T
MUDDAH	M AH D AH
MUDDAI	M AH D EY
MUDDAT	M AH D AH T
MUEEN	M Y UW AH AH N
MUFAHIMAT	M Y UW F AE HH AH M AH T
MUFAKKIR	M Y UW F AE K AH R
MUFASSAR	M Y UW F AH S AH R
MUFEED	M Y UW F IY D
MUFIR	M Y UW F AH R
MUFLIS	M AH F L AH S
MUG	M AH G
MUGHAL	M AH AH L
MUGHALON	M AH AH L AH N
MUGHIS	M AH AH S
MUGHLIA	M AH L IY AH
MUGHRABI	M AH R AH B IY
MUHABBAT	M AH HH AE B AH T
MUHAFIZON	M AH HH AE F AH Z AH N
MUHAJIR	M AH HH AH JH AH R
MUHAMMAD	M UH HH AA M AH D
MUHAQIQ	M AH HH AH K AH K
MUHAR	M AH AH R
MUHAYA	M AH HH EY AH
MUHAYYAR	M AH HH EY AY AH R
MUHIM	M AH HH AH M
MUHLIQ	M AH L AH K
MUHMIN	M AH M AH N
MUJAHID	M Y UW JH AH HH AH D
MUJAHY	M Y UW JH AH IY
MUJARRAD	M Y UW JH AE R AH D
MUJAWAZA	M Y UW JH AO AH Z AH
MUJEEB	M Y UW JH IY B
MUJH	M AH JH
MUJHAY	M AH JH HH EY IY
MUJHE	M AH JH HH
MUJHY	M AH JH IY
MUJRIM	M AH JH R AH M
MUKHAFFAF	M AH K AE F AH F
MUKHAIYAR	M AH K EY AY AH R
MUKHALIFAT	M AH K AE L AH F AH T
MUKHBIRI	M AH K B AH R IY
MUKHIL	M AH K AH L
MUKHRA	M AH K R AH
MUKHRE	M AH K R
MUKHTALIF	M AH K T AH L AH F
MUKHZAN	M AH K Z AH N
MULAKAT	M Y UW L AH K AH T
MULAQAT	M Y UW L AH K AH T
MULAWIS	M Y UW L AH AH S
MULAZIM	M Y UW L AH Z AH M
MULAZIMAT	M Y UW L AE Z AH M AH T
MULAZIMEEN	M Y UW L AH Z AY M IY AH N
MULAZMAT	M Y UW L AE Z M AH T
MULAZMEEN	M Y UW L AE Z M IY AH N
MULHIQ	M AH L HH AH K
MULHIQA	M AH L HH AH K AH
MULK	M UH K
MULKI	M UH L K IY
MULLAON	M AH L AH AO N
MUMALIK	M Y UW M AH L AH K
MUMANIYAT	M Y UW M AH N IY AY AH T
MUMASIL	M Y UW M AH S AH L
MUMBAI	M UH M B AY
MUMBAI	M UH M B AY
MUMKIN	M AH M K IH N
MUMLIKAT	M AH M L AH K AH T
MUMLKTIN	M AH M L K T AH N
MUN	M AH N
MUNAFA	M Y UW N AH F AH
MUNAFEY	M Y UW N EY F IY
MUNAQQID	M Y UW N AE K AH D
MUNASHIYAAT	M Y UW N AH SH IY AY AH T
MUNASIB	M Y UW N AH S AH B
MUNAWAR	M Y UW N AH AH R
MUNAZZAM	M Y UW N AE Z AH M
MUNDHE	M AH N D HH
MUNEEB	M Y UW N IY B
MUNEEB	M Y UW N IY B
MUNFARID	M AH N F AH R AH D
MUNHADIM	M AH N HH AH D AH M
MUNICH	M Y UW N IH K
MUNIR	M Y UW N AH R
MUNQISH	M AH N K AH SH
MUNSHI	M AH N SH IY
MUNSHION	M AH N SH AH N
MUNSHIYANA	M AH N SH IY AY AH N AH
MUNTAKHIB	M AH N T AE K AH B
MUNTAKHIBAAT	M AH N T AE K AH B AH T
MUNTAKIL	M AH N T AH K AH L
MUNTAZIR	M AH N T AH Z AH R
MUQABLAY	M AH K AE B L EY IY
MUQABLON	M AH K AE B L AH N
MUQARRAR	M AH K AE R AH R
MUQAWI	M AH K AH IY
MUQAYYAD	M AH K EY AY AH D
MURAD	M Y UH R AE D
MURAGHAN	M Y UH R AH AH N
MURATTAB	M Y AH R AE T AH B
MUREE	M Y AH R IY IY
MURGH	M AH R
MURGHA	M AH R AH
MURGHABIYON	M AH R AH B IY AY AH N
MURGHI	M AH R IY
MURGHIYAN	M AH R IY AY AH N
MURGHON	M AH R AH N
MURH	M AH R
MURJHA	M AH R JH HH AH
MURLI	M AH R L IY
MURRABE	M AH R EY B
MURREE	M ER IY
MURSHAD	M AH R SH AH D
MUSADDIQ	M Y UW S AE D AH K
MUSAKHAR	M Y UW S AH K AH R
MUSALMAAN	M Y UW S AE L M EY AH N
MUSALMAN	M Y UW Z AH L M AE N
MUSALSAL	M Y UW Z AH L Z AH L
MUSANIF	M Y UW S AH N AH F
MUSAVIRON	M Y UW S AE V AH R AH N
MUSAWIR	M Y UW S AH AH R
MUSBAT	M AH Z AH T
MUSEEBAT	M Y UW Z IY B AE T
MUSHAFI	M AH SH AH F IY
MUSHAIRA	M AH SH AE AH R AH
MUSHAQAT	M AH SH AH K AH T
MUSHARRAF	M AH SH AE R AH F
MUSHAWARAT	M AH SH AO AH R AH T
MUSHFIQ	M AH SH AH K
MUSHKIL	M AH SH AH L
MUSHTAIL	M AH SH T EY L
MUSHTI	M AH SH T IY
MUSIC	M Y UW Z IH K
MUSIR	M Y UW S AH R
MUSLIM	M AH Z L AH M
MUSLIM(2)	M AH Z L IH M
MUSTAGHNI	M AH S T AH N IY
MUSTAID	M AH S T EY D
MUSTARD	M AH S T ER D
MUTA-ARIF	M Y UW T AH AE R AH F
MUTABIQ	M Y UW T AH B AH K
MUTAFFAR	M Y UW T AE F AH R
MUTAFIQA	M Y UW T AE F AH K AH
MUTAGHAYUR	M Y UW T AE EY AH R
MUTAGHRAQ	M Y UW T AH R AH K
MUTAHARIK	M Y UW T AE HH AH R AH K
MUTAHIDDA	M Y UW T AH HH IH D AH
MUTAHIRA	M Y UW T AE HH AH R AH
MUTAIN	M Y UW T EY N
MUTAKHREEN	M Y UW T AE K R IY AH N
MUTALA	M Y UW T AH L AH
MUTALBA	M Y UW T AE L B AH
MUTALBE	M Y UW T AH L B IY
MUTALEA	M Y UW T EY L IY AH
MUTALIQ	M Y UW T AH L AH K
MUTALON	M Y UW T AH L AO N
MUTANAZIA	M Y UW T AH N EY Z IY AH
MUTARAJIM	M Y UW T ER AH JH IH M
MUTASIRA	M Y UW T AE S AH R AH
MUTASIREEN	M Y UW T AH S AY R IY AH N
MUTASSIR	M Y UW T AE S AH R
MUTAWAFFI	M Y UW T AH AE F IY
MUTAWE	M Y UW T AH
MUTAYANA	M Y UW T EY AH N AH
MUTRADIF	M AH T R AH D AH F
MUTWAFI	M AH T W AH F IY
MUTWAJA	M AH T W AH JH AH
MUWASILAT	M AH W AA S AH L AH T
MUWZIAAT	M AH W Z IY AH T
MUYASSIR	M Y UW AY AE S AH R
MUZAFFAR	M Y UW Z AE F AH R
MUZAYYAN	M Y UW Z EY AY AH N
MY	M AY
MZARAON	M Z AE R EY AH N
N	EH N
N	EH N
NA	N AA
NAAKIS	N AA K AH S
NAAM	N AA M
NAAME	N AA M
NAAMZAD	N AA M Z AH D
NABIYUZ	N EY B IY AY AH Z
NABOOAT	N AE B UW AH T
NABOYAN	N AE B OY AH N
NABVI	N AE B IY
NACH	N AE CH
NACHA	N AE CH AH
NACHEEZ	N AH CH IY Z
NACHNAY	N AE K N EY IY
NADEEM	N EY D IY M
NADIR	N EY D ER
NAE	N IY
NAEEM	N IY AH M
NAEHLI	N IY L IY
NAFAL	N EY F AH L
NAFIZ	N AE F AH Z
NAFLI	N AE F L IY
NAGAR	N AE G ER
NAGHA	N AE AH
NAGHMA	N AE M AH
NAH	N AA
NAHAYEIN	N AE HH EY IY N
NAHEEF	N AH HH IY F
NAHI	N AE HH IY
NAHOOSAT	N AH HH UW S AH T
NAI	N EY
NAIB	N EY B
NAIMAT	N EY M AH T
NAIMATON	N EY M AH T AH N
NAJAAIZ	N AE JH AH AH Z
NAJAF	N AE JH AH F
NAKAAM	N AE K AH M
NAKEIN	N EY K IY N
NAKHRE	N AE K R
NAKHSON	N AE K S AH N
NAKHUD	N AE K AH D
NAKHWASTA	N AE K W AA S T AH
NAKSHE	N AE K
NAMAK	N AE M AH K
NAMAZ	N AE M AH Z
NAME	N EY M
NAMF	N AE M F
NAMI	N AE M IY
NAMOODAR	N AH M UW D AH R
NAMU	N AE M UW
NAMWAR	N AE M W AH R
NANGA	N AE N G AH
NANGAY	N AE N G EY IY
NANHA	N AE N HH AH
NANHE	N AE N HH
NANHI	N AE N HH IY
NANI	N AE N IY
NANIYAAL	N EY N IY AY EY AH L
NAQAL	N AE K AH L
NAQASH	N AE K AH SH
NAQAZON	N AE K AH Z AH N
NAQRAS	N AE K R AH Z
NAQSH	N AE K
NAQSHA	N AE K AH
NAQSHBANDI	N AE K B AE N D IY
NAQWI	N AE K W IY
NARGHAY	N AA R EY IY
NARGIS	N AA R JH AH S
NARKH	N AA R K
NARKHON	N AA R K AH N
NASAL	N EY Z AH L
NASB	N AE Z
NASEEB	N EY S IY B
NASEEHAT	N EY S IY HH AH T
NASEIN	N EY S IY N
NASFSIYATI	N AE S IY AY AH T IY
NASHAIB	N AH SH EY B
NASHAR	N AE SH AH R
NASHASTA	N AH SH AE S T AH
NASHE	N AE SH
NASHISHT	N AE SH AH SH T
NASHOWNUMA	N AE SH OW N Y UW M AH
NASHTA	N AE SH T AH
NASHU	N AE SH UW
NASREEN	N EY Z R IY AH N
NATAIJ	N AH T EY JH
NATEEJA	N EY T IY JH AH
NATEEJAY	N EY T IY JH EY
NATHI	N AE TH IY
NATHNON	N AE TH N AH N
NATION	N EY SH AH N
NATIONAL	N AE SH AH N AH L
NATIONAL(2)	N AE SH N AH L
NATIVE	N EY T IH V
NATURAL	N AE CH ER AH L
NATURAL(2)	N AE CH R AH L
NATURE	N EY CH ER
NAU	N OW
NAUBAT	N AO B AH T
NAUJAWAN	N AO JH AH AH N
NAUKHEZ	N AO K AH Z
NAUMEEDI	N AH M IY D IY
NAUNEHAL	N AO N AH AH L
NAUROZ	N AO R AH Z
NAUY	N AO IY
NAUZ	N AO Z
NAUZAYEDA	N AH Z EY AH D AH
NAVASI	N AE V AH S IY
NAVEED	N EY V IY D
NAWAB	N AO AH B
NAWAZ	N AO AH Z
NAWAZA	N AO AH Z AH
NAWAZNEIN	N AO AH Z N IY N
NAWAZON	N AO AH Z AH N
NAWE	N AO
NAWEESON	N AO IY S AH N
NAWEIN	N AO IY N
NAY	N EY
NAYA	N EY AH
NAYE	N EY
NAYI	N EY IY
NAZAM	N AE Z AH M
NAZAN	N EY Z AH N
NAZAR	N AA Z AA R
NAZAR	N AA Z AA R
NAZARIYE	N AH Z AE R IY AY
NAZARSANI	N AH Z AA R S AH N IY
NAZDEEK	N AE Z D IY K
NAZIM	N AE Z AH M
NAZIMABAD	N AH Z IH M AH B AH D
NAZIR	N AE Z AH R
NAZLE	N EY Z AH L
NAZLEY	N AE Z L IY
NAZRON	N AE Z R AH N
NDOY	N D OW IY
NE	N IY
NE(2)	N EY
NEECHA	N IY CH AH
NEECHE	N IY CH
NEECHI	N IY CH IY
NEED	N IY D
NEEDLE	N IY D AH L
NEEL	N IY L
NEELAM	N IY L AH M
NEELGUN	N IY L G AH N
NEEM	N IY M
NEEROO	N IH R UW
NEEZ	N IY Z
NEGATIVE	N EH G AH T IH V
NEHAR	N EH AH R
NEON	N IY AA N
NERANG	N EH R AH NG
NESCHEN	N EH S AH N
NETO	N EH T OW
NEURO	N UH R OW
NEVER	N EH V ER
NEW	N UW
NEW(2)	N Y UW
NEWS	N UW Z
NEWS(2)	N Y UW Z
NEWSNATION	N UW Z N EY SH AH N
NEXT	N EH K S T
NEXT(2)	N EH K S
NEYAMAT	N EY AH M AH T
NEZEY	N IY Z IY
NHI	N HH IY
NIBHAAYE	N IH B HH AH AY
NIBHANE	N IH B HH EY N
NICHALE	N AH CH EY L
NICHAWAR	N IH CH AH AH R
NICHLI	N IH K L IY
NICHOR	N IH CH ER
NIDA	N IY D AH
NIDAR	N AY D AH R
NIDHAL	N IH D AH L
NIGHAT	N AY AH T
NIGHAWAR	N AY AO ER
NIGHDASHT	N AY D AH SH T
NIGHT	N AY T
NIGRAAN	N IH G R EY AH N
NIGRANI	N IH G R AH N IY
NIHA	N IH HH AH
NIHAYAT	N IH HH EY AH T
NIJAAT	N IH JH AH T
NIJI	N IH JH IY
NIKAAB	N IH K AH B
NIKAL	N AY K AH L
NIKALEN	N IH K AH L AH N
NIKALI	N IH K AH L IY
NIKHAR	N IH K AH R
NIKHARA	N IH K AH R AH
NIKHRA	N IH K R AH
NIKHWAT	N IH K W AH T
NIKLA	N IH K L AH
NILOFER	N AH L OW F AH R
NIMTAIN	N IH M T EY N
NINANWAY	N AH N AE N W EY IY
NINE	N AY N
NINETEEN	N AY N T IY N
NINETY	N AY N T IY
NINUNVE	N IH N AH N V
NINYAANVE	N IH N AY AH N V
NIRKH	N AH R K
NISAAR	N IH S EY AH R
NISF	N IH S
NISHAAN	N IH SH EY AH N
NISHAN	N IH SH AH N
NISHANA	N IH SH AH N AH
NISWAN	N IH S W AH N
NITROGENY	N AY T R AH JH AH N IY
NIZAAM	N IH Z AH M
NIZAD	N IH Z AH D
NM	EH N M
NO	N OW
NOAABADYATI	N OW AH B AH D AY AH T IY
NOBLE	N OW B AH L
NOCH	N AA CH
NOCHANDI	N AH CH AE N D IY
NOCHEN	N AA CH AH N
NOFEL	N AA F AH L
NOGO	N OW G OW
NOHA	N AA HH AH
NOHE	N AA HH
NOJAWANON	N AH JH AO AH N AH N
NOMOLOOD	N AA M AH L UW D
NOO	N UW
NOODLES	N UW D AH L Z
NOOI	N UW IY
NOON	N UW N
NOOR	N OW AH R
NORTH	N AO R TH
NOSH	N AA SH
NOSHAD	N AA SH AH D
NOSHERVAN	N AH SH AH R V AH N
NOT	N AA T
NOTICE	N OW T AH S
NOTICE(2)	N OW T IH S
NOVEL	N AA V AH L
NOVEMBER	N OW V EH M B ER
NOW	N AW
NOYAT	N OY AH T
NOZLON	N AA Z L AH N
NOZZEL	N AA Z AH L
NSHRWASHAAT	N SH R W AA SH AH T
NSHYI	N SH AY IY
NU	N UW
NUCLEAS	N AH K L IY Z
NUDRAT	N AH D R AH T
NUFOOS	N Y UW F UW Z
NULL	N AH L
NUMA	N Y UW M AH
NUMAINDA	N Y UW M EY N D AH
NUMAYA	N Y UW M EY AH
NUMBER	N AH M B ER
NUMBERS	N AH M B ER Z
NUMERAL	N UW M ER AH L
NUQOOSH	N AH K UW SH
NUQSAAN	N AH K S EY AH N
NURSEN	N ER S AH N
NUSKHA	N AH S AH
NUSKHE	N AH S
NUSKHON	N AH S AH N
NUVE	N Y UW V
NUZOOL	N Y UW Z UW L
O	OW
O	OW
OA	OW AH
OBAASH	AA B AH SH
OCTOBER	AA K T OW B ER
OD	AA D
ODHIO	AA D HH IY OW
OF	AH V
OFCOURSE	AA F OW R S
OFFICE	AO F AH S
OFFICERAN	AO F AH S R AE N
OFFICIALS	AH F IH SH AH L Z
OHDAY	AA D EY IY
OHDEDARON	AH D EH D AH R AH N
OHO	AA HH OW
OJHRI	AA JH HH R IY
OK	OW K EY
OKA	OW K AH
OKAY	OW K EY
OLAY	OW L EY
OLD	OW L D
OMEGA	OW M EH G AH
OMEGA(2)	OW M EY G AH
ON	AA N
ON(2)	AO N
ONCE	W AH N S
ONCHE	AO NG K
ONE	W AH N
ONE(2)	HH W AH N
ONES	W AH N Z
ONEY	OW N IY
ONLINE	AO N L AY N
ONLY	OW N L IY
OOCHAY	UW CH EY IY
OODH	UW D
OOHAAM	UW HH AH M
OONI	UW N IY
OONS	UW N Z
OOPAR	UW P AH R
OOS	UW Z
OPEN	OW P AH N
OPERATION	AA P ER EY SH AH N
OPERATOR	AA P ER EY T ER
OPERATOR	AA P ER EY T ER
OPOSITION	AA P AH Z IH SH AH N
OR	AO R
OR(2)	ER
ORDINENCE	AO R D AH N AH N S
ORGANIZATION	AO R G AH N AH Z EY SH AH N
ORGANIZING	AO R G AH N AY Z IH NG
ORH	AO R
ORHA	AO R AH
ORIYAN	AH R IY AY AH N
OSMANI	AA Z M AH N IY
OTHER	AH DH ER
OTHERWISE	AH DH ER W AY Z
OUCHAN	AW CH AH N
OUR	AW ER
OUR(2)	AW R
OUR(3)	AA R
OUT	AW T
OVER	OW V ER
OVERHEAD	OW V ER HH EH D
OVERLOADING	OW V ER L OW D IH NG
OWN	OW N
OXYGEN	AA K S AH JH AH N
OXYGEN(2)	AA K S IH JH AH N
OYE	OY
P	P IY
P	P IY
PAACH	P AA CH
PAAK	P AA K
PAANCH	P AA N CH
PAANCHON	P AA NG K AH N
PAAS	P AA Z
PAASBAN	P AA Z AH N
PABUNDI	P AH B AH N D IY
PACHAAS	P AE CH AH Z
PACHANVE	P AE CH AH N V
PACHAS	P AE CH AH Z
PACHASSI	P AH CH AE S IY
PACHHIS	P AE CH AH S
PACHIIS	P AE CH IY AH S
PACHIS	P AE CH AH S
PACHPAN	P AE CH AH N
PACKAGE	P AE K AH JH
PACKAGE(2)	P AE K IH JH
PAENSATH	P IY N S AH TH
PAENTALIS	P IY N T AH L AH S
PAENTEES	P IY N T IY Z
PAENTIIS	P IY N T IY AH S
PAENTTALIIS	P IY N T EY L IY AH S
PAGRI	P AE G R IY
PAGRIYAN	P AE G R IY AY AH N
PAHAR	P AE AH R
PAHARI	P AE HH AH R IY
PAHATTAR	P AH HH AE T AH R
PAHONCH	P AE HH AH N CH
PAHORON	P AE HH AH R AH N
PAHUCHOON	P AE HH AH CH UW N
PAHUNCH	P AE HH AH N CH
PAHUNCHA	P AH HH AH NG K AH
PAHUNCHAYA	P AH HH AH NG K EY AH
PAHUNCHI	P AH HH AH NG K IY
PAHUNCHNE	P AE HH AH NG K N
PAHUNCHTE	P AE HH AH NG K T
PAICHEEDA	P EY CH IY D AH
PAIDA	P EY D AH
PAIDAIESH	P EY D EY AH SH
PAIDAWAR	P EY D AH W AO R
PAISAY	P EY S EY IY
PAISH	P EY AH SH
PAISON	P EY Z AO N
PAKAYE	P AE K EY
PAKEEZGI	P EY K IY Z IY
PAKI	P AE K IY
PAKISTAN	P AE K IH S T AE N
PAKKA	P AE K AH
PAKORON	P AE K AH R AH N
PALARE	P AE L AH R
PALASTINE	P AE L AH S T AY N
PALLU	P AE L UW
PALMAR	P AA M ER
PALON	P AE L AO N
PALOTHI	P AE L AH TH IY
PALRA	P AE L R AH
PAMPHLET	P AE M F L AH T
PANCH	P AE N CH
PANCHAWAN	P AE NG K AH AH N
PANCHHI	P AE NG K IY
PANCHOLI	P AE NG K AH L IY
PANCHWIEN	P AE NG K W IY AH N
PANDRA	P AE N D R AH
PANDRAH	P AE N D R AH
PANE	P EY N
PANGOORE	P AE N G OW OW R
PANHAN	P AE N AH N
PANI	P AE N IY
PANJ	P AE N JH
PANJABI	P AE N JH AH B IY
PANJGANA	P AE N JH AH N AH
PANJNAD	P AE N JH N AH D
PANKH	P AE NG K
PANKHA	P AE NG K AH
PANKHARI	P AE NG K AH R IY
PAPER	P EY P ER
PAR	P AA R
PARA	P EH R AH
PARACHA	P AE R AH CH AH
PARAKHCHE	P AE R AH K
PARAO	P AE R EY OW
PARATHA	P AE R AH TH AH
PARATHE	P AH R EY DH
PARCHA	P AA R K AH
PARCHAIYAN	P AA R K EY AY AH N
PARCHAM	P AA R K AH M
PARCHIYAN	P AA R K IY AY AH N
PARESHAA	P AE R AH SH AH
PARESHAN	P AE R AH SH AH N
PARH	P AA R
PARHAI	P AA R EY
PARHAIZ	P AH R EY Z
PARHAYEN	P AA R HH EY AH N
PARHE	P AA R
PARHEIN	P AH R IY N
PARHEN	P AA R HH EH N
PARHI	P AA R IY
PARHIYE	P AA R IY AY
PARHNAY	P AA R N EY IY
PARHNE	P AA R N
PARHO	P AA R OW
PARI	P AE R IY
PARKHA	P AA R K AH
PARKHE	P AA R K
PARLIMANY	P AA R L IH M AH N IY
PARLIMENTARIAN	P AA R L AH M AH N T EH R IY AH N
PARLOUR	P AA R L ER
PAROSI	P AE R AH S IY
PARPOOJA	P AA R P UW JH AH
PARR	P AA R
PARRE	P AE R
PARTA	P AA R T AH
PARTY	P AA R T IY
PARVEEN	P AA R V IY AH N
PARWA	P AA R W AH
PARYOON	P AE R AY UW N
PAS	P AA Z
PASADAY	P AA Z AH D EY
PASAND	P AE S AH N D
PASANDIDA	P AH S AE N D AH D AH
PASDARI	P AE Z D AH R IY
PASHANGOI	P AH SH AE N G OY
PASMANDAH	P AE Z M AE N D AH
PASMURDAH	P AE Z M AH R D AH
PASSION	P AE SH AH N
PASSPORT	P AE S P AO R T
PATA	P AE T AH
PATAKHE	P AE T AH K
PATHAN	P AE TH AH N
PATHAR	P AE TH ER
PATHARON	P AE TH ER AO N
PATHE	P AE TH
PATHOLOGIST	P AH TH AA L AH JH AH S T
PATHOLOGY	P AH TH AA L AH JH IY
PATHON	P AE TH AO N
PATHRI	P AE TH R IY
PATHRIYAN	P AE TH R IY AY AH N
PATHUN	P AE TH AH N
PATNA	P AE T N AH
PAUNE	P AO N
PAYA	P EY AH
PAYEDAR	P EY D ER
PAZALBASH	P AH Z AE L B AH SH
PCHASOYN	CH AH S OY N
PE	P IY
PECHEEDGYON	P AH CH IY JH AY AH N
PECHOTRI	P AH CH AA T R IY
PEDA	P EH D AH
PEDAWAAR	P AH D AO EY AH R
PEECHA	P IY CH AH
PEECHE	P IY CH
PEECHEY	P IY CH IY
PEER	P IH R
PEERON	P IH ER AO N
PEESNE	P IY Z N
PEET	P IY T
PEETH	P IY TH
PEGHAM	P EH G HH AE M
PEGHAMBAR	P EH G HH AE M B AA R
PEHAL	P EH AH L
PEHALWAN	P AH HH AE L W AH N
PEHAM	P EH HH AH M
PEHCHAN	P EH CH AH N
PEHENTE	P EH HH AH N T
PEHLA	P EH L AH
PEHLE	P EH L
PEHLI	P EH L IY
PEHLU	P EH L UW
PEHLVON	P EH L V AH N
PEHNA	P EH N AH
PEHNE	P EH N
PEHSAAB	P EH S AH B
PEN	P EH N
PENSATH	P EH N S AH TH
PER	P ER
PERATHRYDE	P AH R AE TH R AY D
PERFECT	P ER F EH K T
PERFECT(2)	P ER F IH K T
PERFORM	P ER F AO R M
PERFORMANCE	P ER F AO R M AH N S
PERIOD	P IH R IY AH D
PEROKAAR	P AH R AA K EY AH R
PEROKARON	P AH R AA K AH R AH N
PERVI	P AH R V IY
PESH	P EH SH
PESHE	P EH SH
PESHGI	P EH SH JH IY
PESHGOIYAN	P EH SH G OY AY AH N
PESHKASH	P EH SH AH SH
PESHKASHEN	P EH SH AH SH AH N
PESHKASHON	P EH SH AH SH AH N
PESHQADMI	P EH SH AE D M IY
PESHRAFT	P EH SH R AH F T
PESHROH	P EH SH R OW
PESHWA	P EH SH W AH
PETH	P EH TH
PETIONER	P EH SH AH N ER
PETROLEUM	P AH T R OW L IY AH M
PEY	P IY IY
PHAAR	F EY AH R
PHAHEY	F AE IY
PHAIL	F EY L
PHAIR	F EH R
PHAIREN	F AE AH R AH N
PHAL	F AE L
PHALIYAN	F EY L IY AY AH N
PHALON	F AE L AH N
PHANS	F AE N Z
PHANSAY	F AE N S EY IY
PHANSE	F AE N S
PHANSI	F AE N S IY
PHAPHOONDI	F AH F UW N D IY
PHARPHARAYE	F AA R F AH R EY
PHASE	F EY Z
PHAT	F AE T
PHATAK	F AE T AH K
PHBTI	F B T IY
PHEEKA	F IY K AH
PHELA	F EH L AH
PHELAO	F EH L EY OW
PHELAY	F EH L EY IY
PHELEEN	F IY L IY AH N
PHELNE	F EH L N
PHENKA	F EH NG K AH
PHEPHRAY	F EH F R EY IY
PHEPHRON	F EH F R AH N
PHEREN	F IY R AH N
PHERNE	F AH R N
PHERTE	F AH R T
PHIR	F IH R
PHISAL	F AY Z AH L
PHOBIA	F OW B IY AH
PHONE	F OW N
PHOOG	F UW G
PHOOL	F UW L
PHOONK	F UW NG K
PHOOPHEN	F UW F AH N
PHOSPHATE	F AA S F EY T
PHOSPHORUS	F AA S F ER AH S
PHRASE	F R EY Z
PHUAR	F Y UW AH R
PHULKI	F UH L K IY
PHUNCHA	F AH NG K AH
PHUNCHEN	F AH N CH AH N
PHUPPO	F AH P OW
PHURKAR	F AH R K AH R
PHURTI	F AH R T IY
PHYSIOTHERAPIST	F IH S IY AH TH EH R AH P AH S T
PICHAR	P IH CH AH R
PICHATAR	P AH CH EY T AH R
PICHLA	P IH K L AH
PICHLE	P IH K L
PICTURE	P IH K CH ER
PIECE	P IY S
PIGHAL	P AY AH L
PIGHLY	P AY L IY
PIGLA	P IH G L AH
PINJARON	P IH N JH AA R AO N
PINJRE	P IH N JH AH R
PIRACY	P AY R AH S IY
PIRHI	P IH R IY
PIROYA	P IH R OY AH
PIROYEN	P IH R OY AH N
PISHROON	P IH SH R UW N
PISTOL	P IH S T AH L
PISTOLEN	P IH S T AH L AH N
PITCH	P IH CH
PITCHEN	P IH CH AH N
PITCHES	P IH CH IH Z
PITHU	P IH TH UW
PIYEN	P AY IY AH N
PK	P IY K
PK10B114447	P IY K EY W AH N Z IY R OW B IY W AH N W AH N F OW R F OW R F OW R S EH V AH N
PLACE	P L EY S
PLATE	P L EY T
PLAYER	P L EY ER
PLEASE	P L IY Z
PLENTY	P L EH N T IY
PLENTY(2)	P L EH N IY
PLUG	P L AH G
POACHA	P OW CH AH
POHACH	P AA HH AH CH
POHANCHAYEN	P AH HH AE NG K EY AH N
POHNCH	P AA N CH
POHUNCHANE	P AA HH AH NG K EY N
POHUNCHAUN	P AH HH AH NG K AH N
POINT	P OY N T
POLICE	P AH L IY S
POLICE	P AH L IY S
POLICIYON	P AA L AH S IY IY AO N
POLICY	P AA L AH S IY
POLIO	P OW L IY OW
PONCH	P AA N CH
PONCHNE	P AO NG K N
PONEY	P OW N IY
POOCH	P UW CH
POOCHEN	P UW CH AH N
POOCHI	P UW CH IY
POOCHIYE	P UW CH IY AY
POOCHNAY	P UH K N EY IY
POOCHO	P UW CH OW
POOORAY	P UW AO R EY IY
POORA	P UH R AH
POP	P AA P
POSHEEDA	P AH SH IY D AH
POTOHARI	P AH T AA HH AH R IY
POUCHON	P AW CH AO N
POUCHYE	P AW CH AY
POWDER	P AW D ER
POWER	P AW ER
PRACTICE	P R AE K T IH S
PRADHAN	P R AE D AH N
PRCHHAYIN	P R CH EY AH N
PREMIER	P R EH M IH R
PREMIER(2)	P R IY M IH R
PRESIDENT	P R EH Z IH D AH N T
PRESS	P R EH S
PRESSURE	P R EH SH ER
PRHWA	P R W AA
PRINCIPAL	P R IH N S AH P AH L
PRINT	P R IH N T
PRITHVI	P R IH TH V IY
PRIVACY	P R AY V AH S IY
PRIVATE	P R AY V AH T
PRIVATIZATION	P R AY V AH T AH Z EY SH AH N
PROBLEM	P R AA B L AH M
PROBLEMS	P R AA B L AH M Z
PROCESS	P R AA S EH S
PROCESS(2)	P R AO S EH S
PROCESSING	P R AA S EH S IH NG
PROCESSNG	P R OW S EH S NG
PROCESSOR	P R AA S EH S ER
PRODUCTIVE	P R AH D AH K T IH V
PRODUCTIVE(2)	P R OW D AH K T IH V
PRODUCTIVE(3)	P ER D AH K T IH V
PROFESSIONAL	P R AH F EH SH AH N AH L
PROFESSOR	P R AH F EH S ER
PROFILE	P R OW F AY L
PROGRAMME	P R OW G R AE M
PROGRAMMON	P R OW G R AE M AH N
PROGRESSIVE	P R AH G R EH S IH V
PROJECT	P R AA JH EH K T
PRONOUNCE	P R AH N AW N S
PRONOUNCED	P R AH N AW N S T
PRONOUNCIATION	P R AH N AW N S IY EY SH AH N
PRONOUNCING	P R AH N AW N S IH NG
PRONUNCIATION	P R OW N AH N S IY EY SH AH N
PRONUNCIATION(2)	P R AH N AH N S IY EY SH AH N
PRTAYSH	P R T EY SH
PTHL	P IY T IY EY CH L
PU	P UW
PUBLISHING	P AH B L IH SH IH NG
PÙULON	P Y UW L AH N
PUNJABI	P AH N JH AH B IY
PUR	P ER
PURAANA	P Y UH R AH N AH
PURAY	P Y UH R EY IY
PURCAHSE	P AH R K AH S
PURJOSH	P AH R JH AH SH
PURLUTF	P AH R L AH T
PURNAM	P AH R N AH M
PURRIYAN	P AH R IY AY AH N
PURSISH	P ER S IH SH
PURSOZ	P AH R S AH Z
PURSUKOON	P AH R S AH K UW N
PURTAYUSH	P AH R T EY AH SH
PUT	P UH T
PYARA	P AY AH R AH
Q	K Y UW
Q	K Y UW
QAAF	K AA F
QAARI	K AA R IY
QAAZI	K AA Z IY
QABAILI	K AH B EY L IY
QABAL	K EY B AH L
QABEELEY	K EY B IY L IY
QABEH	K AE B
QABIL	K AE B AH L
QABRUSTAN	K AE B R AH S T AH N
QABZE	K AE B Z
QAD	K AE D
QADAM	K AE D AH M
QADAREN	K AE D AH R AH N
QADR	K AE D R
QADRAY	K AE D R EY IY
QADRI	K AE D R IY
QADRON	K AE D R AH N
QADYANI	K AH D AY AH N IY
QAFAS	K AE F AH Z
QAID	K EY D
QAIDIYON	K EY D IY AY AH N
QAIM	K EY M
QALA	K AE L AH
QALAM	K AE L AH M
QALEEN	K EY L IY AH N
QALZUM	K AE L Z AH M
QAM	K AE M
QANDEEL	K AE N D IY L
QANOON	K AH N UW N
QARAAR	K AE R EY AH R
QARARDAD	K AH R AA R D AH D
QAREEB	K AH R IY B
QAREEBI	K AH R IY B IY
QARYIN	K AE R AY AH N
QARZAY	K AA R Z EY IY
QARZON	K AA R Z AH N
QASAM	K AE S AH M
QASIM	K AE S AH M
QASOOR	K AE S OW AH R
QASOORWAR	K AH S UH R W AH R
QATAL	K EY T AH L
QAUID	K AO AH D
QAUMI	K AO M IY
QAWAM	K AO AH M
QAWANEEN	K AO EY N IY AH N
QAY	K EY IY
QAYAM	K EY AH M
QAYAMAT	K EY AH M AH T
QAYYAM	K EY AY AH M
QAYYUM	K EY AY AH M
QAZA	K AE Z AH
QAZAF	K AE Z AH F
QAZIYE	K EY Z IY AY
QDOQAMT	K D AA K AH M T
QDROQIMT	K D R AA K AH M T
QEEMAT	K IY M AH T
QEHAT	K EH HH AH T
QIASER	K AY AH Z AH R
QINAAT	K IH N AH T
QISMATI	K IH Z M AH T IY
QIYAM	K AY AY AH M
QOMI	K OW M IY
QOMYAYE	K AA M AY EY
QOOAT	K UW AH T
QOOD	K UW D
QOS	K AA Z
QOUM	K AW M
QUAAF	K W AA F
QUAF	K W AA F
QUARTER	K W AO R T ER
QUATON	K W AA T AH N
QUBOOL	K W B UW L
QUDRATI	K W D R AE T IY
QUDSE	K W D S
QUDSIYA	K W D S IY AY AH
QUE	K Y UW
QUEEN	K W IY N
QUH	K W
QUIZ	K W IH Z
QUL	K W L
QUOMI	K W AA M IY
QURESHI	K UH R EY SH IY
QUSOOR	K W S OW AH R
QUYOOD	K W AY UW D
R	AA R
R	AA R
RAABTA	R AA B T AH
RAABTEY	R AA B T IY
RAAG	R AA G
RAAJ	R AA JH
RAANJHAN	R AA N JH AH N
RAASTEY	R AA S T IY
RAAT	R AA T
RAAYTIN	R AA AH T AH N
RAAZDAN	R AA Z D AH N
RABIYA	R EY B IY AY AH
RACER	R EY S ER
RACHAO	R AE CH EY OW
RADDEAMAL	R AE D IY M AH L
RADEEF	R EY D IY F
RADIO	R EY D IY OW
RAEES	R IY Z
RAEGA	R IY G AH
RAFEEQ	R EY F IY K
RAFIA	R EY F IY AH
RAFIYA	R EY F IY AY AH
RAFT	R AE F T
RAFTAR	R AE F T ER
RAFU	R AE F UW
RAG	R AE G
RAGEN	R AE G AH N
RAGHBAT	R AE B AH T
RAGHIB	R AE AH B
RAGREN	R AE G R AH N
RAHA	R AE HH AH
RAHABAR	R AE HH AH B AH R
RAHAGEER	R AE AH JH IH R
RAHAY	R AE HH EY IY
RAHDARI	R AE D AH R IY
RAHE	R EY HH IY
RAHEEM	R AH HH IY M
RAHEN	R AE AH N
RAHEY	R AE IY
RAHGEER	R AH JH IH R
RAHI	R AE HH IY
RAHIL	R AE HH AH L
RAHIYE	R AE HH IY AY
RAHNUMA	R AE N Y UW M AH
RAHNUMAON	R AE N Y UW M EY AH N
RAHO	R AE HH OW
RAHTEY	R AE T IY
RAIJ	R EY JH
RAIYAT	R EY AY AH T
RAJAN	R EY JH AH N
RAJE	R EY JH
RAJIA	R EY JH IY AH
RAKH	R AE K
RAKHA	R AE K AH
RAKHAO	R AE K EY OW
RAKHE	R AE K
RAKHEIN	R AE K IY N
RAKHEN	R AE K AH N
RAKHI	R AE K IY
RAKHIYO	R AE K IY AY OW
RAKHNA	R AE K N AH
RAKHNE	R AE K N
RAKHNEY	R AE K N IY
RAKHO	R AE K OW
RAKHSHANDA	R AE K AE N D AH
RAKHTA	R AE K T AH
RAKHTAY	R AE K T EY IY
RAKHTHA	R AE K TH AH
RAKHUN	R AE K AH N
RAKHWA	R AE K W AH
RAMBO	R AE M B OW
RAMZI	R AE M Z IY
RANDHAWA	R AE N D HH AH AH
RANG	R AE NG
RANGED	R EY N JH D
RANGEELA	R AE N JH IY L AH
RANGEEN	R EY N JH AH N
RANGERS	R EY N JH ER Z
RANGON	R AE NG AO N
RANJHA	R AE N JH HH AH
RANJIDA	R AE N JH AH D AH
RANJISH	R AE N JH AH SH
RAO	R AW
RAQAM	R AE K AH M
RAQEEB	R AH K IY B
RAQIM	R AE K AH M
RAQS	R AE K S
RAQSAN	R AE K S AH N
RASAO	R AE S EY OW
RASEEDA	R EY S IY D AH
RASEEDAH	R EY S IY D AH
RASHA	R AE SH AH
RASHEED	R AH SH IY D
RASHID	R AH SH IY D
RASHID(2)	R AA SH IY D
RASIKH	R AE S AH K
RASOLI	R AE S AH L IY
RASOOL	R AH S UW L
RASTAY	R AE S T EY IY
RASTEN	R AE S AH N
RATHOR	R AE TH AH R
RAUF	R AO F
RAUSHNEEYON	R AO SH N IY AY AH N
RAVAYON	R AE V EY AH N
RAVI	R AA V IY
RAVLA	R AE V L AH
RAWAAT	R AO AH T
RAWAN	R AO AH N
RAWAYE	R AO EY
RAWAYYA	R AO EY AY AH
RAWAYYE	R AO EY AY
RAWISH	R AO IH SH
RAY	R EY
RAYAN	R EY AH N
RAYE	R EY
RAYGAN	R EY G AH N
RAYWAR	R EY W AO R
RAZA	R AE Z AH
RAZZAQ	R AE Z AH K
RDAY	R D EY IY
READ	R EH D
READ(2)	R IY D
READING	R IY D IH NG
READING(2)	R EH D IH NG
REAL	R IY L
REALLY	R IH L IY
REALLY(2)	R IY L IY
RECEPTIONIST	R IH S EH P SH AH N IH S T
RECEPTIONIST(2)	R IY S EH P SH AH N IH S T
RECIEVER	R AH S IY V AH R
RECORD	R AH K AO R D
RECORD(2)	R EH K ER D
RECORD(3)	R IH K AO R D
RECORDING	R AH K AO R D IH NG
RECORDING(2)	R IH K AO R D IH NG
RECORDING	R AH K AO R D IH NG
RECORDING(2)	R IH K AO R D IH NG
RED	R EH D
REECH	R IY EH CH
REECHON	R IY EH CH AH N
REENGTI	R IY AH N G T IY
REERH	R IY EH R
REFERENDUM	R EH F ER EH N D AH M
REFUGE	R EH F Y UW JH
REGIONAL	R IY JH AH N AH L
REGISTRATION	R EH JH IH S T R EY SH AH N
REGULAR	R EH G Y AH L ER
REGULAR(2)	R EY G Y AH L ER
REH	R EH
REHAISH	R AH HH EY AH SH
REHAM	R IY HH AE M
REHANA	R AH HH AE N AH
REHMAT	R IH HH M AE T
REHTA	R IH HH T AA
REHTAY	R IH HH T EY IY
REHTE	R IH HH T IY
REHZANI	R IH HH Z AE N IY
RELAX	R IH L AE K S
RELAX(2)	R IY L AE K S
RELEASE	R IY L IY S
RELIEF	R IH L IY F
RELIEF(2)	R IY L IY F
REMARKS	R IH M AA R K S
REMARKS(2)	R IY M AA R K S
REMEMBER	R IH M EH M B ER
REMEMBER(2)	R IY M EH M B ER
REPEAT	R IH P IY T
REPEAT(2)	R IY P IY T
REPORT	R IY P AO R T
REPORT(2)	R IH P AO R T
REPRTASH	R IH P R T AE SH
REQUEST	R IH K W EH S T
REQUEST(2)	R IY K W EH S T
REQUIREMENT	R IH K W AY R M AH N T
RERIYAN	R AH R AY AY AH N
RESCUE	R EH S K Y UW
RESEARCH	R IY S ER CH
RESERVE	R IH Z ER V
RESERVE(2)	R IY Z ER V
RESERVES	R IH Z ER V Z
RESERVES(2)	R IY Z ER V Z
RESHMI	R IH SH M IY
RESHON	R AH SH AA N
RESOLUTION	R EH Z AH L UW SH AH N
RESTAURANT	R EH S T ER AA N T
RESTAURANT(2)	R EH S T R AA N T
RESULT	R IH Z AH L T
RESULT(2)	R IY Z AH L T
RETIRED	R IH T AY R D
RETIRED(2)	R IY T AY ER D
RETIRED(3)	R IY T AY R D
RETIREMENT	R IY T AY ER M AH N T
RETIREMENT(2)	R IH T AY ER M AH N T
RETURN	R IH T ER N
RETURN(2)	R IY T ER N
REVENUE	R EH V AH N UW
REVENUE(2)	R EH V AH N Y UW
REVERSE	R IH V ER S
REVERSE(2)	R IY V ER S
REVIEW	R IY V Y UW
REY	R EY
RHA	R AA
RHE	R IY
RHI	R IY
RIAYAT	R AY AE AY AH T
RIAZ	R AY AH Z
RIFFAT	R IH F AH T
RIGHT	R AY T
RIHAISHI	R AH HH EY SH IY
RIKH	R IH K
RIMJHIM	R IH M JH HH AH M
RINGTE	R IH N G T
RIRHHI	R AH R HH IY
RISHTAY	R IH SH T EY IY
RISK	R IH S K
RISORS	R AY Z ER Z
RIWAYAT	R IH W EY AH T
RIYASAT	R AY AY AH S AH T
RIZVI	R IH Z IY
RIZWAN	R IH Z W AH N
RJ	AA R JH
RO	R OW
ROAD	R OW D
ROBIN	R AA B AH N
ROBIN(2)	R AA B IH N
ROGHAN	R AA AH N
ROGHNYAAT	R AA N AY AH T
ROHI	R AA HH IY
ROIDAAD	R OY D AH D
ROJHAAN	R AA JH HH EY AH N
ROLL	R OW L
RONAQ	R AA N AH K
RONE	R OW N
RONGTE	R AA N G T
ROOD	R UW D
ROOH	R UW
ROOHANI	R UW HH AH N IY
ROOHEN	R UW AH N
ROOHI	R UW HH IY
ROOM	R UW M
ROOSHANAS	R UW SH AH N AH Z
ROOSI	R UW S IY
ROOTH	R UW TH
ROOTHEN	R UW T HH EH N
ROOYAT	R UW AY AH T
ROSHAN	R AA SH AH N
ROSHANAAS	R AA SH AH N AH Z
ROSHNI	R AA SH N IY
ROUN	R AW N
ROUNDER	R AW N D ER
ROVER	R OW V ER
ROYA	R OY AH
ROYE	R OY
ROZ	R AA Z
ROZA	R OW Z AH
ROZANA	R AA Z AH N AH
ROZE	R OW Z
ROZEY	R OW Z IY
ROZGAAR	R AA Z EY AH R
ROZNAMA	R AA Z N AH M AH
ROZON	R AA Z AH N
RQASAON	R K AE S EY AH N
RRAY	R EY IY
RSYA	R S AY AH
RUBAB	R UW B AH B
RUE	R UW
RUJHAAN	R AH JH HH EY AH N
RUJOO	R UW JH UW
RUKAN	R UW K AH N
RUKH	R AH K
RUKHO	R AH K OW
RUKHSAARO	R AH K S AH R OW
RUKHSAT	R AH K S AH T
RULA	R UW L AH
RULES	R UW L Z
RUNG	R AH NG
RUNS	R AH N Z
RUPEY	R UW P IY
RUQOOM	R AH K UW M
RUQQIA	R AH K IY AH
RUSHDI	R AH SH D IY
RUSOOKH	R UW S AH K
RUSWAI	R AH S W EY
RUTH	R UW TH
S	EH S
S	EH S
SA	S AA
SAA-AT	S AA AE T
SAAD	S AA D
SAADAT	S AA D AH T
SAAF	S AA F
SAAHAB	S AA HH AH B
SAAL	S AA L
SAALGIRAH	S AA L JH AH R AH
SAALMIYAT	S AA L M IY AY AH T
SAAMNE	S AA M
SAAMNEY	S AA M N IY
SAANGI	S AA N JH IY
SAARA	S AA R AH
SAARI	S AA R IY
SAARIFEEN	S AH R AY F IY AH N
SAARIYO	S AH R IY AY OW
SAAROUN	S AH R AW N
SAAT	S AA T
SAATH	S AA TH
SAATHI	S AA TH IY
SAATHIYON	S AH TH IY AY AH N
SAATHWEIN	S AA TH W IY N
SAAZ	S AA Z
SAAZGAR	S AA Z AH R
SAAZI	S AA Z IY
SAB	S AE B
SABAB	S AE B AH B
SABAK	S AE B AH K
SABARO	S AE B AH R OW
SABGHAT	S AE B AH T
SABHA	S AE B HH AH
SABIQ	S AE B AH K
SABIR	S EY B ER
SABIR(2)	S AH B IH R
SABOOHI	S AH B UW HH IY
SABOOT	S AH B UW T
SABR	S AE B R
SABSIDY	S AE B S AH D IY
SABZ	S AE B Z
SABZI	S AE B Z IY
SABZIYON	S AE B Z IY AY AH N
SABZWARI	S AE B Z W AH R IY
SACH	S AE CH
SACHAI	S AE CH EY
SACHAL	S AE CH AH L
SADAQAT	S AE D AH K AH T
SADDAR	S AE D ER
SAD-E-BAAB	S AE D IY B AA B
SADHU	S AE D HH UW
SADIQ	S AE D AH K
SADIYAN	S EY D IY AY AH N
SADIYON	S AE D IY IY AO N
SAEED	S AA IY D
SAENTALIIS	S IY N T EY L IY AH S
SAENTALIS	S IY N T AH L AH S
SAENTEES	S IY N T IY Z
SAENTIIS	S IY N T IY AH S
SAENTTALIIS	S IY N T EY L IY AH S
SAENTTIS	S IY N T AH S
SAFAH	S AE F AH
SAFAI	S AE F EY
SAFAID	S AH F EY D
SAFAIDI	S AH F EY D IY
SAFAR	S EY F ER
SAFE	S EY F
SAFEDEY	S AH F IY D IY
SAFEER	S EY F IH R
SAFETY	S EY F T IY
SAFFON	S AE F AH N
SAFHA	S AE F AH
SAFHAY	S AE F EY IY
SAFHEIN	S AE F IY N
SAFHON	S AE F AH N
SAFOOF	S AH F UW F
SAGAR	S AA G AA R
SAGE	S EY JH
SAGHAR	S AE AH R
SAGHIR	S AE AH R
SAGHIR	S AE AH R
SAHAB	S AE HH AH B
SAHAFION	S AH HH EY F IY AH N
SAHARA	S AH HH EH R AH
SAHARE	S AE HH AH R
SAHELI	S AE HH AH L IY
SAHI	S AE HH IY
SAHIB	S AE HH AH B
SAHIL	S AE HH AH L
SAHULAT	S AE HH Y UW L AH T
SAIB	S EY B
SAIBAAN	S EY B EY AH N
SAID	S EH D
SAIEN	S EY AH N
SAILORS	S EY L ER Z
SAIR	S AE AH R
SAIRGAH	S AE AH R G AH
SAJATE	S EY JH EY T
SAJDA	S AE JH D AH
SAJJAD	S AE JH AH D
SAJJI	S AE JH IY
SAJJID	S AE JH AH D
SAKAL	S EY K AH L
SAKEIN	S EY K IH N
SAKEN	S EY K AH N
SAKHT	S AE K T
SAKHTA	S AE K T AH
SAKOON	S AH K UW N
SAKOOT	S AH K UW T
SAKTA	S AE K T AH
SAKTEEN	S AE K T IY AH N
SAKTEY	S AE K T IY
SAKTI	S AE K T IY
SALA	S AA L AH
SALAAM	S AH L AA M
SALAHIYAT	S AE L AH HH IY AY AH T
SALAHIYATEN	S AH L AE HH IY AY EY T AH N
SALAM	S AA L AA M
SALAS	S AA L AA Z
SALAY	S AE L EY
SALE	S EY L
SALES	S EY L Z
SALHA	S AE L HH AH
SALOOK	S AE L AH K
SALOOKI	S AE L AH K IY
SAMAAN	S AE M EY AH N
SAMAEEN	S AE M IY AH N
SAMAIT	S AH M EY T
SAMAJH	S AE M AH JH
SAMAJHDAR	S AH M AE JH HH D AH R
SAMAJHNEY	S AH M AE JH HH N IY
SAMAJHTE	S AE M AH JH HH T
SAMANDAR	S AH M AE N D AH R
SAMAR	S AE M AA R
SAMAVI	S AE M AH V IY
SAMBHAAL	S AE M B HH EY AH L
SAMBHAL	S AE M B AH L
SAME	S EY M
SAMET	S AE M IH T
SAMJHA	S AE M JH HH AH
SAMJHAE	S AE M JH HH IY
SAMJHAIN	S AE M JH HH EY N
SAMJHANE	S AE M JH HH EY N
SAMJHAYA	S AE M JH HH EY AH
SAMJHAYEN	S AE M JH HH EY AH N
SAMJHE	S AE M JH HH
SAMJHI	S AE M JH HH IY
SAMJHOO	S AE M JH HH UW
SAMJHOTA	S AE M JH HH AH T AH
SAMNAY	S AE M N EY IY
SAMNE	S AE M
SAMOE	S AE M OW
SAMOSE	S AH M OW Z
SAMOYA	S AE M OY AH
SANDWICH	S AE N D W IH CH
SANDWICH(2)	S AE N W IH CH
SANDWICH(3)	S AE M W IH CH
SANGBAARI	S AE N G AH R IY
SANGEEN	S AE NG IY AH N
SANGHARY	S AE NG HH EH R IY
SANGSAAR	S AE N G S EY AH R
SANIHAY	S AH N IH HH EY IY
SANIHON	S AE N AH HH AH N
SANISH	S EY N IH SH
SANSEIN	S AE N S IY N
SANSON	S AE N S AH N
SANWAR	S AE N W AH R
SANWLE	S AE N W L
SAQAFAT	S AE K AH F AH T
SAQIB	S AE K AH B
SAR	S AA R
SARA	S EH R AH
SARAE	S AE R IY
SARAKKE	S AE R AH K
SARBARAH	S AA R B AH R AH
SARDI	S AA R D IY
SARDIYON	S AA R D IY AY AH N
SARE	S EH R
SAREAAM	S AE R IY AH M
SARFARAZ	S AA R F AH R AH Z
SARGARMIYON	S AA R G AH R M IY AY AH N
SARHAD	S AA R AH D
SARHANDI	S AH R AE N D IY
SARHE	S AA R
SARHNE	S AA R N
SARKARI	S AA R K AH R IY
SARMAYE	S AA R M EY
SARON	S AE R AH N
SARSATH	S AA R S AH TH
SARTASATH	S AA R T AH S AH TH
SARWAR	S AA R W AH R
SARZAMEEN	S AA R Z EY M IY AH N
SATANVE	S AE T AH N V
SATARVEN	S AH T AA R V AH N
SATASSI	S AH T AE S IY
SATAWAN	S AE T AH W AA N
SATH	S AE TH
SATHI	S AE TH IY
SATHIYON	S AH TH IY AY AH N
SATHRA	S AE TH R AH
SATHYON	S AE TH AY AH N
SATKE	S AE T
SATRA	S AE T R AH
SATTAIIS	S AE T EY AH S
SATTAR	S AE T ER
SATTATTAR	S AE T AE T ER
SATTH	S AE T TH
SATURDAY	S AE T ER D IY
SATURDAY(2)	S AE T IH D EY
SATWEN	S AE T W AH N
SAU	S AO
SAUBATEN	S AH B EY T AH N
SAUDA	S AO D AH
SAUDI	S AO D IY
SAUDI(2)	S AW D IY
SAUHBAT	S AO B AH T
SAULA	S AO L AH
SAUM	S AO M
SAUNF	S AO N F
SAURI	S AO R IY
SAVE	S EY V
SAW	S AO
SAWA	S AO W AH
SAWAB	S AO AH B
SAWAD	S AO AH D
SAWAL	S AO AH L
SAWARA	S AO AH R AH
SAWERA	S AO IH R AH
SAWEREY	S AO IY R IY
SAY	S EY
SAYA	S EY AH
SAYAH	S EY AH
SAYAHAT	S EY AH HH AE T
SAYE	S EY
SAYER	S EY ER
SAYS	S EH Z
SAYS(2)	S IH Z
SAYYAD	S EY AY AH D
SAYYADA	S EY AY AH D AH
SAYYAHAT	S EY IY AH HH AE T
SAYYARE	S EY AY AH R
SAYYARON	S EY ER AO N
SAZA	S AE Z AH
SAZAA	S AE Z AH
SAZAEIN	S AE Z IY AH N
SAZ-BAAZ	S AE Z B AA Z
SAZ-O-SAMAAN	S AE Z OW S AE M EY AH N
SCHOOL	S K UW L
SCHOOLON	S K UW L AO N
SCIENCEDAANON	S IY N S EH D AH N AH N
SCORES	S K AO R Z
SCRIPT	S K R IH P T
SE	S EY
SEASON	S IY Z AH N
SECHEHRE	S EH CH AH R
SECOND	S EH K AH N D
SECONDLY	S EH K AH N D L IY
SECURITY	S IH K Y UH R AH T IY
SEE	S IY
SEEDHA	S IY D HH AH
SEEDHE	S IY D HH
SEEING	S IY IH NG
SEEKH	S IY K
SEEKHA	S IY K AH
SEEKHE	S IY K
SEEKHEN	S IY K HH EH N
SEEKHI	S IY K IY
SEEKHNAY	S IY K N EY IY
SEEKHNE	S IY K N
SEEN	S IY N
SEENGH	S IY N
SEER	S IY R
SEERAT	S IY R AE T
SEERHIYAN	S AH R IY AY AH N
SEERHYION	S AH R AY IY AH N
SEESEY	S IY Z IY
SEHAR	S EH AH R
SEHAT	S EH HH AH T
SEHOONI	S AH HH UW N IY
SEIES	S EY Z
SEKHA	S EH K AH
SEKHO	S EH K OW
SELF	S EH L F
SEMEE	S IY M IY IY
SEMINAR	S EH M AH N AA R
SENIOR	S IY N Y ER
SENKRON	S EH NG K R AH N
SENNET	S EH N AH T
SENTENCE	S EH N T AH N S
SEPTEMBER	S EH P T EH M B ER
SERAAB	S EH R AH B
SERIAL	S IH R IY AH L
SERIES	S IH R IY Z
SERVANT	S ER V AH N T
SERVICE	S ER V AH S
SERVICE(2)	S ER V IH S
SESAMIC	S EH S AH M IY IH K
SESSION	S EH SH AH N
SET	S EH T
SETH	S EH TH
SEVEN	S EH V AH N
SEVENTEEN	S EH V AH N T IY N
SEVENTY	S EH V AH N T IY
SEWERAGE	S UW ER IH JH
SEWING	S OW IH NG
SEY	S IY IY
SH	EH S
SHAADI	SH AA D IY
SHAAEY	SH AA IY
SHAAKH	SH AA K
SHAAKHEN	SH AA K AH N
SHAAKHON	SH AA K AH N
SHAAM	SH AA M
SHAAMIL	SH AA M AH L
SHAB	SH AE B
SHADE	SH EY D
SHADEED	SH EY D IH D
SHADI	SH AE D IY
SHADOW	SH AE D OW
SHAEN	SH EY AH N
SHAER	SH EY ER
SHAFAF	SH AE F AH F
SHAFIQUE	SH AE F AH K
SHAFQAT	SH AE F AH T
SHAGAAF	SH AE G AH F
SHAGIRD	SH AE JH AH R D
SHAGOOFE	SH AH G UW F
SHAGOONI	SH AH G UW N IY
SHAGUFATA	SH AE G Y UW F AH T AH
SHAGUFON	SH AE G Y UW F AH N
SHAH	SH AA
SHAHAB	SH AE HH AH B
SHAHABIYE	SH AH HH EY B IY AY
SHAHBAZ	SH AE B AH Z
SHAHEED	SH AH HH IY D
SHAHEEN	SH AH HH IY N
SHAHID	SH AA AH D
SHAHJAHAN	SH AE JH AH AH N
SHAHNAWAZ	SH AE N AH AH Z
SHAHRAH	SH AE R AH
SHAHRAH	SH AE R AH
SHAHSDAR	SH AE S D AH R
SHAI	SH AY
SHAIQEEN	SH EY K IY AH N
SHAIR	SH AE AH R
SHAJAR	SH EY JH AH R
SHAKHS	SH AE K S
SHAKHSANA	SH AE K S AH N AH
SHAKHSE	SH AE K S
SHAKHSHIYAT	SH AE K IY AY AH T
SHAL	SH AE L
SHALA	SH AE L AH
SHALJAM	SH AE L JH AH M
SHAME	SH EY M
SHAMIL	SH AE M AH L
SHAMOLIAT	SH AH M OW L IY AH T
SHAMPOO	SH AE M P UW
SHAMS	SH AE M Z
SHAMSHAD	SH AE M SH AH D
SHAMSI	SH AE M Z IY
SHANAKHT	SH AE N AH K T
SHANAKHTI	SH AH N AE K T IY
SHANASI	SH AE N AH S IY
SHANDAAR	SH AE N D EY AH R
SHAOLE	SH EY OW L
SHAOORI	SH EY AH R IY
SHAORI	SH EY AH R IY
SHAPE	SH EY P
SHARE	SH EH R
SHAREEF	SH AH R IY F
SHAREEFAIN	SH AE R AH F EY N
SHARING	SH EH R IH NG
SHARON	SH AE R AH N
SHARON(2)	SH EH R AH N
SHARON(3)	SH AH R OW N
SHARWADB	SH AA R W AH D
SHASH	SH AE SH
SHAUBA	SH AO B AH
SHAUKAT	SH AO K AH T
SHAUKAT	SH AO K AH T
SHAULON	SH AO L AH N
SHAUQ	SH AO K
SHAUR	SH AO R
SHAWAHID	SH AO AH HH IH D
SHAWALA	SH AO AH L AH
SHAYAD	SH EY AH D
SHAYAN	SH EY AH N
SHAYAR	SH EY AH R
SHAZO	SH AE Z OW
SHCEDULE	SH S IY D Y UW L
SHE	SH IY
SHEDAI	SH EH D EY
SHEEN	SH IY N
SHEER	SH IH R
SHEEREEN	SH IH R IY AH N
SHEEREY	SH IH R IY
SHEESHEY	SH IY SH IY
SHEESHON	SH IY SH AH N
SHEHAR	SH EH AH R
SHEHRI	SH EH R IY
SHEHRION	SH EH R IY AH N
SHEHRON	SH EH R AH N
SHEHZAD	SH EH Z AH D
SHEHZADI	SH EH Z AH D IY
SHEIKH	SH IY K
SHEKHI	SH EH K IY
SHELL	SH EH L
SHELTER	SH EH L T ER
SHEPHERD	SH EH P ER D
SHER	SH ER
SHERATON	SH EH R AH T AH N
SHERWAANI	SH AH R W AH N IY
SHIBLI	SH IH B L IY
SHIDAT	SH IH D AH T
SHIELD	SH IY L D
SHIELDEN	SH IY L D AH N
SHIFAAT	SH IH F AH T
SHIKAAR	SH IH K EY AH R
SHIKAR	SH AY K AH R
SHIKAYAT	SH IH K EY AH T
SHIRKAT	SH AH R K AH T
SHIYA	SH AY AY AH
SHKHS	EH S EY CH K EY EY CH S
SHOBO	SH OW B OW
SHOES	SH UW Z
SHOHRAT	SH AA R AH T
SHOKH	SH AA K
SHOKHI	SH AA K IY
SHOOL	SH UW L
SHOON	SH UW N
SHOQAT	SH AA K AH T
SHOR	SH AO R
SHORT	SH AO R T
SHOSHA	SH AA SH AH
SHOULD	SH UH D
SHOW	SH OW
SHOWCASON	SH OW K AH S AH N
SHUA	SH UW W AH
SHUAON	SH UW W EY AH N
SHUAR	SH UW W AH R
SHUARA	SH UW W AH R AH
SHUBA	SH UW B AH
SHUBHAAT	SH AH B HH AH T
SHUBHE	SH AH B HH
SHUDA	SH UW D AH
SHUDHY	SH AH D IY
SHUGHAL	SH AH AH L
SHUGOON	SH UW G UW N
SHUJAAT	SH UW JH AH T
SHUKAR	SH UW K AH R
SHUKARIYA	SH UW K AH R IY AY AH
SHUKRIA	SH AH K R IY AH
SHUMAAR	SH UW M EY AH R
SHUMARIYAT	SH UW M AH R IY AY AH T
SHUNEED	SH UW N IY D
SHURU	SH UH R UW
SHURUVAAT	SH AH R UW V AH T
SHUSTA	SH AH S T AH
SHUYOOKH	SH UW W AY AH K
SHVE	SH V IY
SI	S IY
SIDDIQUEEN	S IH D IH K IY AH N
SIDE	S AY D
SIDHU	S IH D HH UW
SIDIQQIQUE	S AH D IH K AH K
SIDRA	S IH D R AH
SIESMOGRAPH	S IY Z M AA G R AH F
SIFAR	S AY F AH R
SIFER	S AY F AH R
SIGHA	S AY AH
SIGN	S AY N
SIHONI	S IH HH AH N IY
SIKANJABEEN	S IH K AH N JH EY B IY AH N
SIKHON	S IH K AH N
SILENT	S AY L AH N T
SILSILAY	S IH L S IH L EY IY
SILSILEN	S IH L S AH L AH N
SILVER	S IH L V ER
SIM	S IH M
SIMAJI	S IH M AH JH IY
SIMDHI	S IH M D HH IY
SIMILAR	S IH M AH L ER
SIMPLE	S IH M P AH L
SIMPLY	S IH M P L IY
SIN	S IH N
SINDHIYON	S IH N D HH IY AY AH N
SINDHU	S IH N D HH UW
SINF	S IH N F
SINGH	S IH NG
SINGHAR	S IH N AH R
SINGLE	S IH NG G AH L
SION	S AY AH N
SIPAHIYON	S IH P AH HH IY AY AH N
SIPEHAR	S IH P AH AH R
SIR	S ER
SIRF	S AH R F
SISTER	S IH S T ER
SIWA	S IH W AH
SIX	S IH K S
SIXTEEN	S IH K S T IY N
SIXTY	S IH K S T IY
SIYAASAT	S AY AY AH S AH T
SIYASAT	S AY AY AH S AH T
SKI	S K IY
SKOON	S K UW N
SKTA	S K T AA
SKTI	S K T IY
SLJHAYIN	S L JH HH EY AH N
SMAJHA	S M AE JH HH AH
SMALL	S M AO L
SMITH	S M IH TH
SMUGGELERON	S M AH G JH EH L ER AO N
SMUGGLING	S M AH G L IH NG
SMUGGLING(2)	S M AH G AH L IH NG
SNATCH	S N AE CH
SNBHLI	S N B HH L IY
SO	S OW
SOACH	S OW CH
SOBAI	S AA B EY
SOBERS	S OW B ER Z
SOCH	S AA CH
SOCHA	S OW CH AH
SOCHE	S AA CH
SOCHEN	S AA CH AH N
SOCHIYE	S AA CH IY AY
SOCHNAY	S AA K N EY IY
SOCHO	S AA CH OW
SOCHON	S AA CH AH N
SOCIAL	S OW SH AH L
SOCIALISM	S OW SH AH L IH Z AH M
SOCIETY	S OW S AY IH T IY
SOCK	S AA K
SODA	S OW D AH
SOEYM	S OW AH AH M
SOFT	S AA F T
SOFT(2)	S AO F T
SOGHAAT	S AA AH T
SOGHWAAR	S AA W EY AH R
SOHBATON	S AA B AH T AH N
SOJNAY	S AA JH N EY IY
SOKHTA	S AA K T AH
SOLA	S OW L AH
SOLAN	S OW L AH N
SOLDIER	S OW L JH ER
SOLING	S OW L IH NG
SOME	S AH M
SOMETHING	S AH M TH IH NG
SOMETIMES	S AH M T AY M Z
SONE	S OW N
SONPI	S AA N P IY
SOOD	S UW D
SOOJAN	S UW JH AH N
SOOJH	S UW JH
SOOJHI	S UW JH HH IY
SOOJI	S UW JH IY
SOOKH	S UH K
SOOKHA	S UH K AH
SOOKHE	S UH K
SOOKHI	S UH K IY
SOOKHNE	S UH K N
SOONGNE	S UW N
SOORAJ	S UH R AH JH
SOORAKH	S UH R AH K
SOORAT	S UH R AH T
SOORMA	S UH R M AH
SOOWAN	S UW W AH N
SOOZISH	S UW Z AH SH
SORBA	S AO R B AH
SORRY	S AA R IY
SOU	S UW
SOUD	S AW D
SOUND	S AW N D
SOUNDED	S AW N D IH D
SOUNDS	S AW N D Z
SOUNDS(2)	S AW N Z
SOUTH	S AW TH
SOVEN	S OW V AH N
SOVIET	S OW V IY AH T
SOVIET(2)	S OW V IY EH T
SOYA	S OY AH
SOYE	S OY
SOYEN	S OY AH N
SPANISH	S P AE N IH SH
SPASNAMH	S P AE Z N AH M
SPEAKERS	S P IY K ER Z
SPELL	S P EH L
SPELLING	S P EH L IH NG
SPINNING	S P IH N IH NG
SPRAY	S P R EY
SPURD	S P AH R D
SQUAD	S K W AA D
SQUADRON	S K W AA D R AH N
SRDKHANE	S R D K HH EY N
STADUIM	S T AH D UW M
STANDARD	S T AE N D ER D
START	S T AA R T
STATION	S T EY SH AH N
STERLING	S T ER L IH NG
STODNTS	S T AA D N T S
STORES	S T AO R Z
STORY	S T AO R IY
STUDENT	S T UW D AH N T
STUDENTS	S T UW D AH N T S
STUDIED	S T AH D IY D
STUDIOS	S T UW D IY OW Z
STUDY	S T AH D IY
SUAAD	S W EY AH D
SUABI	S W EY B IY
SUAD	S W EY D
SUANI	S W EY N IY
SUB	S AH B
SUBAH	S AH B AE
SUBAYE	S AH B EY
SUBHA	S AH B HH AA
SUBHEN	S AH B HH EH N
SUBON	S AH B AO N
SUBSCRIBE	S AH B S K R AY B
SUDHEER	S AH D IH R
SUDHOOR	S AH D HH OW AH R
SUDHRE	S AH D HH R
SUDIOS	S UW D IY AH Z
SUFI	S UW F IY
SUFIA	S UW F IY AH
SUFIYANA	S UW F IY AY AH N AH
SUGAR	SH UH G ER
SUGHAR	S AH AH R
SUGHRA	S AH R AH
SUHAGA	S AH HH AH G AH
SUHRU	S AH R UW
SUIYAN	S UW AY AH N
SUIYON	S UW IY IY AO N
SUJHAI	S AH JH HH EY
SUKHI	S AH K IY
SUKHN	S AH K N
SUKOON	S UW K UW N
SULA	S UW L AH
SULJHAYIN	S AH L JH HH EY AH N
SULPHATE	S AH L F EY T
SULTAN	S AH L T AH N
SUMROO	S AH M R UW
SUN	S AH N
SUNAATEY	S AH N AH EY T IY
SUNAYA	S UW N EY AH
SUNE	S UW N
SUNEN	S AH N AH N
SUNGHASAN	S AH N AH Z AH N
SUNIYE	S UW N IY AY
SUNNAT	S AH N AH T
SUNO	S UW N OW
SUNTA	S AH N T AH
SUNWAATEY	S AH N W EY EY T IY
SUNWAY	S AH N W EY
SUNYEIN	S UW N AY IY N
SUPER	S UW P ER
SUPPOSED	S AH P OW Z D
SURAIYYA	S UH R EY AY AY AH
SURATEHAAL	S UH R AH T EH HH EY AH L
SURE	SH UH R
SURF	S ER F
SURKH	S AH R K
SURKHI	S AH R K IY
SURKHIAL	S AH R K IY AH L
SURKHUROO	S AH R K Y AH R UW
SURVEY	S ER V EY
SURVEYOR	S ER V EY ER
SUSRAAL	S AH Z R EY AH L
SUST	S AH S T
SUTHRA	S AH TH R AH
SUTHRE	S AH TH R
SUZUKI	S AH Z UW K IY
SVOYN	S V OY N
SWEATERS	S W EH T ER Z
SWEDISH	S W IY D IH SH
SWEETER	S W IY T ER
SWIFT	S W IH F T
SWIMMING	S W IH M IH NG
SWING	S W IH NG
SWISS	S W IH S
SWITCH	S W IH CH
SYASI	S AY AH S IY
SYED	S AY D
SYMBOL	S IH M B AH L
SYMPHONY	S IH M F AH N IY
SYRINGEN	S AH R IH N JH AH N
SYSTEM	S IH S T AH M
T	T IY
T	T IY
TAAHAM	T AA HH AH M
TA-AJUB	T AA AE JH AH B
TAALIB	T AA L AH B
TAALLAH	T AA L AH
TAAMEER	T AH M IH R
TAAMUL	T AA M AH L
TAAQAT	T AA K AH T
TAAQUB	T AA K W B
TAARUF	T AA R AH F
TAAWUN	T AA W AH N
TABAEEN	T AE B IY AH N
TABAHI	T AE B AH HH IY
TABASSUM	T AH B AE S AH M
TABDEEL	T AE B D IY L
TABDEELI	T AE B D AH L IY
TABDEELIAN	T AE B D IY L IY AH N
TABDEELIYON	T AE B D AH L IY AY AH N
TABEE	T AE B IY
TABISH	T AE B IH SH
TABIYYAT	T EY B IY AY AY AH T
TABLEEGH	T AE B L IY
TABLEEGHI	T AE B L IY IY
TABLO	T AE B L OW
TADAAD	T AE D AH D
TADABEER	T AE D AH B IH R
TADFEEN	T AE D F IY AH N
TADREES	T EY D R IY Z
TAEES	T IY Z
TAENTALIS	T IY N T AH L AH S
TAENTEES	T IY N T IY Z
TAENTIS	T IY N T AH S
TAFARRUQA	T AH F AE R AH K AH
TAFAUL	T AE F AH L
TAFAWUT	T AE F AH AH T
TAFFANUN	T AE F AH N AH N
TAFHEEM	T AE F IY M
TAFREEHI	T AE F R AH HH IY
TAFTEESH	T AE F T IY SH
TAFTEESHI	T AE F T AH SH IY
TAFUN	T AE F AH N
TAFWEEZ	T AE F W IY Z
TAGHAFUL	T AE AH F AH L
TAGHAYYYUR	T AE EY AY AY AH R
TAGHLUQ	T AE L AH K
TAGHOTI	T AE AH T IY
TAHAEF	T AH HH IY F
TAHAFUZ	T AE HH AH F AH Z
TAHAMMUL	T AH HH AE M AH L
TAHAYUR	T AE HH EY AH R
TAHAYYA	T AH HH EY AY AH
TAHIEN	T AE HH IY AH N
TAIESE	T EY IY Z
TAIYUSHAT	T EY AY AH SH AH T
TAIZ	T EY Z
TAJARBA	T AH JH AA R B AH
TAJARBAAT	T AH JH AA R B AH T
TAJARUD	T AE JH AH R AH D
TAJDAAR	T AE JH D EY AH R
TAJHEEZ	T AE JH HH IY Z
TAJIR	T AE JH AH R
TAJIRON	T AE JH AH R AH N
TAJVEEZ	T AE JH IY Z
TAJWAR	T AE JH W AH R
TAJWEEZ	T AE JH W IY Z
TAJZIA	T AE JH Z IY AH
TAJZIYE	T AE JH Z IY AY
TAJZIYON	T AE JH Z IY AY AH N
TAK	T AE K
TAKALUF	T AE K AH L AH F
TAKAYUL	T AE K EY AH L
TAKE	T EY K
TAKEEZA	T EY K IY Z AH
TAKHALUS	T AE K AH L AH S
TAKHEER	T AH K IH R
TAKHFEEF	T AE K IY F
TAKHLEEQ	T AE K L IY K
TAKHREEB	T AE K R IY B
TAKMEEL	T AE K M IY L
TAKNIKI	T AE K N AH K IY
TALABAY	T AH L AE B EY IY
TALABB	T AE L AH B
TALASH	T AE L AH SH
TALE	T EY L
TALEED	T EY L D
TALEEM	T EY L IY M
TALEY	T EY L IY
TALK	T AO K
TALKH	T AE L K
TALKHI	T AE L K IY
TALKHIYAN	T AE L K IY AY AH N
TALKHIYON	T AE L K IY AY AH N
TALLO	T AE L OW
TALMEEHAAT	T AE L M IY HH AH T
TALQON	T AE L K AH N
TALUQ	T AE L AH K
TALUQAT	T AE L AH K AH T
TALWAR	T AE L W AH R
TAMAAM	T AE M AH M
TAMAM	T AE M AH M
TAMANAON	T AH M AE N EY AH N
TAMASHAIYON	T AE M AH SH EY AY AH N
TAMASKHUR	T AH M AE S AH R
TAMGHA	T AE M AH
TAMGHE	T AE M
TAMGHON	T AE M AH N
TAMHEES	T AE M HH IY Z
TANAFUSKE	T AE N AH F AH S
TANAO	T AE N EY OW
TANASUB	T AE N AH S AH B
TANAVUL	T AE N AH V AH L
TANAWO	T AE N AH OW
TANAZE	T AH N EY Z
TANAZIA	T AH N EY Z IY AH
TANG	T AE NG
TANG(2)	T AA NG
TANGDASTI	T AE N G D AE S T IY
TANHA	T AE N HH AH
TANK	T AE NG K
TANKEED	T AE NG K IY D
TANKY	T AE NG K IY
TANOLI	T AE N AH L IY
TANQEES	T AE N K IY Z
TANSEEKH	T AE N S IY K
TANZ	T AE N Z
TANZEEM	T AE N Z IY M
TANZULI	T AE N Z AH L IY
TAOOZ	T EY UW Z
TAPSARA	T AE P S AH R AH
TAQALUM	T AE K AH L AH M
TAQARRURARI	T AE K AH R UH R AH R IY
TAQDDUS	T AE K D AH S
TAQDEER	T AE K D IH R
TAQLEEL	T AE K L IY L
TAQREEBA	T AE K R IY B AH
TAQREEBAN	T AE K R IY B AH N
TAQSEEM	T AE K S IY M
TAQUB	T AE K W B
TAQWIYAT	T AE K W IY AY AH T
TARAF	T AE R AH F
TARAH	T AE R AH
TARAJIM	T AA R AH JH IH M
TARAKE	T AH R EY K
TARAKI	T AE R AH K IY
TARAKIYAT	T AE R AH K IY AY AH T
TARAN	T AE R AH N
TARAQI	T AE R AH K IY
TARASHON	T AA R AE SH AO N
TARBIATI	T AA R B IY AH T IY
TAREEFEN	T AA R IY F EH N
TAREEKH	T AH R IY K
TAREEKHON	T AH R IY K AH N
TAREEKHY	T AH R IY K IY
TAREEQA	T AH R IY K AH
TAREEQE	T AH R IY K
TARFS	T AA R F S
TARGHEEB	T AH R IY B
TARHA	T AA R AH
TARHEE	T AH R IY IY
TARJEEH	T AA R JH IY
TARJEEHAT	T AA R JH IY HH AH T
TARJUMAAN	T AA R JH UW M EY AH N
TARJUMANI	T AA R JH UW M AH N IY
TARMEEM	T AA R M IY M
TARPAN	T AA R P AE N
TARRH	T AE R
TARSHOL	T AA R SH AH L
TARWEEJ	T AA R W IY JH
TARZ	T AA R Z
TARZEFIKR	T AA R Z AH F AH K R
TASADUQ	T AE S AH D AH K
TASAHAL	T AE S AH AH L
TASALSUL	T AH S AE L S AH L
TASAWAR	T AE S AH AH R
TASAWUF	T AE S AH AH F
TASDEEQ	T AE Z D IY K
TASFIYA	T AE S IY AY AH
TASFIYE	T AE S IY AY
TASHADUD	T AE SH AH D AH D
TASHAKHUS	T AE SH AH K AH S
TASHANUJ	T AE SH AH N AH JH
TASHAYON	T AE SH EY AH N
TASHBEEH	T AE SH B IY
TASHBEEHEN	T AE SH B IY AH N
TASHBIYAT	T AE SH B IY AY AH T
TASH-HEER	T AE SH HH IY ER
TASHKHEESH	T AE SH IY SH
TASHREEF	T AE SH R IY F
TASHWEESH	T AE SH W IY SH
TASK	T AE S K
TASKHEER	T AE S IH R
TASLEEM	T AE Z L IY M
TASSAVURAAT	T AE S AE V Y AH R AH T
TASUR	T AE S AH R
TASURAT	T AE S AH R AH T
TASVEER	T AE Z IH R
TASVEEREN	T AE Z AH R AH N
TAUFEEQ	T AH F IY K
TAUHEEN	T AO HH IY AH N
TAUHFATAN	T AH F EY T AH N
TAUHMAT	T AO M AH T
TAUSEEF	T AH S IY F
TAUSEEH	T AO S IY
TAUSEEY	T AW Z IY IY
TAUZEEH	T AO Z IY
TAWAJAH	T AO AH JH AH
TAWAJAU	T AO AH JH AH
TAWAQA	T AO AH K AH
TAWAQUAAT	T AO AE K W AH T
TAWAZA	T AO AH Z AH
TAWAZUN	T AO AH Z AH N
TAWEEL	T AO IY L
TAWQAF	T AO K AH F
TAXATION	T AE K S EY SH AH N
TAYANAAT	T EY AH N AH T
TAYYAB	T EY AY AH B
TAYYABA	T EY AY AH B AH
TAYYAQUN	T EY AY AH K W N
TAYYAR	T EY AY AH R
TAYYUN	T EY AY AH N
TAZABZUB	T AH Z AE B Z AH B
TAZEEN	T EY Z IY AH N
TAZHEEQ	T AE Z HH IY K
TAZLEEL	T AE Z L IY L
TDAY	T D EY IY
TEACHER	T IY CH ER
TEACHING	T IY CH IH NG
TEAM	T IY M
TECHNICIANS	T EH K N IH SH AH N Z
TECHNOLOGIES	T EH K N AA L AH JH IY Z
TECHNOLOGY	T EH K N AA L AH JH IY
TECNO	T EH K N OW
TEE	T IY
TEEN	T IY N
TEENS	T IY N Z
TEERGI	T IH R JH IY
TEERON	T IH R AH N
TEES	T IY Z
TEESRAY	T IY Z R EY
TEHATTAR	T AH HH AE T AH R
TEHKEKAAT	T EH K AH K AH T
TEHQEEQ	T EH HH K IY K
TEHREEK	T AH R IY K
TEHREER	T AH R IH R
TEHREERON	T EH R AH R AH N
TEHRO	T EH R OW
TEHSEEL	T AH S IY L
TEHSEELON	T AH S IY L AH N
TEHWAR	T EH W AH R
TEHWEEL	T EH W IY L
TEHZEEB	T AH Z IY B
TEHZEEBI	T AH Z IY B IY
TELEFARE	T EH L AH F EH R
TELENT	T IY L AH N T
TELEPHONE	T EH L AH F OW N
TELEVESION	T AH L IY V Z IY AH N
TELEVISION	T EH L AH V IH ZH AH N
TEN	T EH N
TENS	T EH N Z
TENSION	T EH N SH AH N
TERA	T EH R AH
TERANVE	T EH R AH N V
TERASSI	T AH R AE S IY
TERAY	T EH R EY IY
TERE	T IH R
TERHA	T EH R AH
TERHAN	T EH R AH N
TERHE	T EH R
TERI	T EH R IY
TESER	T S AH R
TEST	T EH S T
TEY	T IY IY
TEZ	T EH Z
TEZI	T EH Z IY
TGHALFUL	T AE L F AH L
TH	T IY EY CH
THA	TH AA
THAAM	TH AA M
THAG	TH AE G
THAI	T AY
THAIIS	TH EY AH S
THAILI	TH EY L IY
THAIWA	TH EY W AH
THAK	TH AE K
THAKUR	TH AE K AH R
THAL	TH AE L
THAM	TH AE M
THANA	TH AE N AH
THANDA	TH AE N D AH
THANEDAAR	TH AH N EH D EY AH R
THANK	TH AE NG K
THANKA	TH AE NG K AH
THANKHOWA	TH AE NG K OW AH
THANKS	TH AE NG K S
THANKYOU	TH AE NG K Y UW
THANON	TH AE N AH N
THAR	TH AA R
THAREY	TH AE R IY
THAT	DH AE T
THAT(2)	DH AH T
THATS	DH AE T S
THAY	TH EY IY
THE	DH AH
THE(2)	DH IY
THEATURE	DH IY EY T Y AH R
THEEK	TH IY K
THEHARNAY	TH AH HH AA R N EY IY
THEHRAO	TH EH R EY OW
THEIR	DH EH R
THEK	TH EH K
THEKANAY	TH AH K AE N EY IY
THEKEDAR	TH EH K AH D AH R
THEKNAY	TH EH K N EY IY
THELE	TH IY L
THEM	DH EH M
THEM(2)	DH AH M
THEME	TH IY M
THEN	DH EH N
THEORY	TH IH R IY
THEORY(2)	TH IY ER IY
THERA	TH EH R AH
THERE	DH EH R
THES	DH AH Z
THESE	DH IY Z
THESIS	TH IY S IH S
THEY	DH EY
THI	TH IY
THIKANE	TH AH K EY N
THINK	TH IH NG K
THIRD	TH ER D
THIRTEEN	TH ER T IY N
THIRTY	TH ER D IY
THIS	DH IH S
THITHAR	TH IH TH AH R
THOHAR	TH AA AH R
THOONS	TH UW N Z
THOOSNE	TH UW Z N
THORA	TH AO R AH
THORE	TH AO R
THORI	TH AO R IY
THOS	DH OW Z
THOSE	DH OW Z
THOTHA	TH AA TH AH
THOUSAND	TH AW Z AH N D
THOUSAND(2)	TH AW Z AH N
THREE	TH R IY
THRESATH	TH R EH S AH TH
THROAT	TH R OW T
THROUGH	TH R UW
THSILDAR	TH S IH L D AH R
THU	TH UW
THUDAY	TH UW D EY IY
THUKRA	TH AH K R AH
THUSA	TH UW S AH
TICHA	T IH CH AH
TIJARAT	T IH JH AH R AH T
TIJORI	T IH JH AH R IY
TIJORIYAN	T IH JH AH R IY AY AH N
TIME	T AY M
TIOILET	T AY OY L AH T
TIP	T IH P
TIRCHI	T AH R CH IY
TIRMAJI	T AH R M AH JH IY
TISSUE	T IH S Y UW
TISSUE(2)	T IH SH UW
TNDHI	T N D HH IY
TO	T UW
TO(2)	T IH
TO(3)	T AH
TODAY	T AH D EY
TODAY(2)	T UW D EY
TOFEL	T AA F AH L
TOGETHER	T AH G EH DH ER
TOH	T OW
TOHFA	T AA F AH
TOHFAY	T AA F EY IY
TOHFON	T AA F AH N
TOJEEH	T OW JH IY
TOLD	T OW L D
TOLEDY	T OW L D IY
TOLIYE	T OW L IY AY
TONGUE	T AH NG
TOO	T UW
TOOFAN	T UW F AH N
TOR	T AO R
TOREN	T AO R AH N
TOU	T UW
TOUHAM	T AW HH AH M
TOURISM	T UH R IH Z AH M
TOURNAMENT	T UH R N AH M AH N T
TOURNAMENTS	T ER N AH M AH N T S
TOWN	T AW N
TOYOTA	T OW Y OW T AH
TOZIHAT	T AA Z AH HH AH T
TRABUNAL	T R AE B Y UW N AH L
TRADE	T R EY D
TRADING	T R EY D IH NG
TRAGEDY	T R AE JH AH D IY
TRAILER	T R EY L ER
TRAIN	T R EY N
TRANFFIC	T R AE N F AH K
TRANSACTION	T R AE N Z AE K SH AH N
TRANSFER	T R AE N S F ER
TRANSFORMER	T R AE N S F AO R M ER
TRANSISTOR	T R AE N Z IH S T ER
TRANSMISSION	T R AE N S M IH SH AH N
TRANSMISSION(2)	T R AE N Z M IH SH AH N
TRANSPARENCY	T R AE N S P EH R AH N S IY
TRAVELERS	T R AE V AH L ER Z
TRAVELERS(2)	T R AE V L ER Z
TREASURY	T R EH ZH ER IY
TREATTAR	T R IY T ER
TREE	T R IY
TRFIN	T R F IH N
TRIBYONL	T R IH B AY AH N L
TROUSER	T R AW Z ER
TRQYON	T R K AY AH N
TRY	T R AY
TSHEEH	T SH IY
TSUNAMI	T S UW N AA M IY
TSUNAMI(2)	S UW N AA M IY
TT	T IY T
TTAENTALIIS	T IY N T EY L IY AH S
TTAENTIIS	T IY N T IY AH S
TTEY	T IY IY
TTUAY	T Y UW EY IY
TU	T UW
TUAAY	T Y UW AH IY
TUBE	T UW B
TUBE(2)	T Y UW B
TUEY	T Y UW IY
TUFAAN	T Y UW F EY AH N
TUFAIL	T Y UW F EY L
TUGHYANI	T AH AY AH N IY
TUK	T UW K
TUKHAM	T AH K AH M
TUM	T AH M
TUMHARAY	T AH M HH AE R EY IY
TUMHARE	T AH M HH AH R
TUMHARI	T AH M HH AH R IY
TUMHARY	T AH M EH R IY
TUMHATAY	T AH M HH AE T EY IY
TUMHE	T AH M HH
TURNS	T ER N Z
TUTION	T Y UW SH AH N
TWELVE	T W EH L V
TWENTY	T W EH N T IY
TWO	T UW
TYAAG	T AY AH G
TYPE	T AY P
TYPHOID	T AY F OY D
TYYARIYAN	T AY AY AH R IY AY AH N
U	Y UW
U	Y UW
UAMR	Y UW AH M R
UBHAR	AH B AH R
UBHRA	AH B HH R AH
UBHRAIN	AH B HH R EY N
UBHRE	AH B HH R
UBHRI	AH B HH R IY
UBOOR	Y UW B OW AH R
UCHAK	AH CH AH K
UCHAL	AH CH AH L
UCHLI	AH K L IY
UDAAS	Y UW D AH Z
UDHAIR	AH D HH AH AH R
UDHAIRNE	AH D HH AH AH R N
UDHAM	AH D HH AH M
UDHAR	AH D AH R
UFAQ	Y UW F AH K
UFTADA	AH F T AH D AH
UGAYE	Y UW G EY
UGLA	AH G L AH
UGNE	AH N
UJAARR	Y UW JH AH R
UJAGAR	Y UW JH AH JH AH R
UJHLAT	AH JH HH L AH T
UJHRE	AH JH HH R
UJLAT	AH JH L AH T
UJRAT	AH JH R AH T
UJRI	AH JH R IY
UKARVI	Y UW K AA R V IY
UKHAAR	AH K EY AH R
UKHARNA	AH K AA R N AH
UL	AH L
ULAJH	Y UW L AH JH
ULFAT	AH L F AH T
ULJHA	AH L JH HH AH
ULJHAN	AH L JH AH N
ULJHAO	AH L JH HH EY OW
ULJHEN	AH L JH AH N
ULJHEY	AH L JH IY
ULJHI	AH L JH HH IY
ULLUL	AH L AH L
ULUQOOL	Y UW L AH K UW L
UMAR	Y UW M AH R
UMEED	Y UW M IY D
UMEEDVAR	Y UW M IY D AH R
UMOOMAN	Y UW M UW M AH N
UMOOR	Y UW M OW AH R
UMPIRE	AH M P AY ER
UMREIN	AH M R IY N
UN	AH N
UN(2)	Y UW EH N
UNAASIWAN	AH N AA S AH W AH N
UNASI	AH N AE S IY
UNATTIS	AH N AE T AH S
UNCHAAS	AH N CH AA Z
UNCHAS	AH N CH AE Z
UNDER	AH N D ER
UNDERGROUND	AH N D ER G R AW N D
UNDERSTAND	AH N D ER S T AE N D
UNFINISHED	AH N F IH N IH SH T
UNGHOOTA	AH N G UW T AH
UNGHOOTE	AH N G UW T
UNGHOOTIYAN	AH N G AH T IY AY AH N
UNGLI	AH N G L IY
UNGOOTHI	AH N G UW TH IY
UNHATTAR	AH N HH AE T ER
UNHEIN	AH N HH IY N
UNHO	AH N HH OW
UNHON	AH N HH AA N
UNHONI	AH N HH OW N IY
UNIDEF	Y UW N AH D EH F
UNIVERSITY	Y UW N AH V ER S AH T IY
UNKO	AH N K OW
UNN	AH N
UNNATEES	AH N EY T IY Z
UNNATTEES	AH N EY T IY Z
UNNIS	AH N AH S
UNSATH	AH N S AE TH
UNSAY	AH N S EY
UNTALIIS	AH N T EY L IY IY Z
UNTALIS	AH N T EY L IY Z
UNTHAK	AH N TH AE K
UNTIL	AH N T IH L
UNWAAN	AH N W EY AH N
UNWAN	AH N W AA N
UP	AH P
UPER	AH P ER
UQAAB	AH K AH B
UQARBA	AH K AA R B AH
UR	ER
URADAY	Y AH R AE D EY IY
URANE	Y AH R EY N
URANIUM	Y ER EY N IY AH M
URAYA	Y UH R EY AH
URAYE	Y UH R EY
URAYEN	Y UH R EY AH N
URDU	ER D UW
UREA	Y ER IY AH
URF	AH R F
URHE	AH R
URHNE	AH R N
UROOJ	Y AH R UW JH
URRA	AH R AH
URRAYIN	AH R EY AH N
URS	AH R Z
URSA	ER S AH
URUN	Y UH R AH N
US	AH S
US(2)	Y UW EH S
USATHWIEN	Y UW S AE TH W IY AH N
USAY	Y UW S EY IY
USE	Y UW S
USE(2)	Y UW Z
USED	Y UW Z D
USER	Y UW Z ER
USHAAK	AH SH AH K
USHAR	AH SH AH R
USKA	AH S AH
USKAY	AH S EY IY
USKI	AH S IY
USKO	AH S OW
USNAY	AH Z N EY IY
USS	Y UW EH S EH S
USSE	AH S
USSI	AH S IY
USTAAD	AH S T AH D
USTAD	AH S T AH D
UTH	AH TH
UTHA	AH TH AH
UTHANE	AH TH EY N
UTHAO	AH TH EY OW
UTHAR	AH TH AH R
UTHAUN	AH TH AH N
UTHAYA	AH TH EY AH
UTHAYE	AH TH EY
UTHAYEN	AH TH EY AH N
UTHE	AH DH
UTHE(2)	AH TH
UTHEEN	AH DH IY AH N
UTHI	AH TH IY
UTHO	AH TH OW
UTHWA	AH TH W AH
UUCHAAL	Y UW AH CH EY AH L
UZAM	Y UW Z AH M
UZBAK	AH Z AH K
UZLAAT	AH Z L AH T
UZMA	AH Z M AH
V	V IY
V	V IY
VALUE	V AE L Y UW
VALVET	V AE L V AH T
VAMP	V AE M P
VAN	V AE N
VED	V EH D
VEEP	V IY P
VERA	V EH R AH
VERIFICAION	V AH R IH F AH K EY IY AH N
VERIFICATION	V EH R AH F AH K EY SH AH N
VERIFY	V EH R AH F AY
VERSION	V ER ZH AH N
VERY	V EH R IY
VIDEO	V IH D IY OW
VIDEOS	V IH D IY OW Z
VIM	V IH M
VIRAL	V AY R AH L
VIRTUAL	V ER CH UW AH L
VIRUS	V AY R AH S
VISA	V IY Z AH
VISION	V IH ZH AH N
VOLLER	V AA L ER
VOLTAGE	V OW L T AH JH
VOLTAGE(2)	V OW L T IH JH
VOLUME	V AA L Y UW M
VORES	V AO R Z
VOWEL	V AW AH L
W	D AH B AH L Y UW
W	D AH B AH L Y UW
WAALA	W AA L AH
WAALI	W AA L IY
WAALID	W AA L AH D
WABAI	W AA B EY
WABAON	W AA B EY AH N
WADA	W AA D AH
WADAY	W AA D EY IY
WADERON	W EY D ER AO N
WADIYAT	W EY D IY AY AH T
WAEED	W IY D
WAFAD	W AA F AH D
WAFAON	W AA F EY AH N
WAFIR	W AA F AH R
WAGARNA	W AH G AA R N AH
WAGES	W EY JH AH Z
WAGES(2)	W EY JH IH Z
WAGHERA	W AA AH R AH
WAGON	W AE G AH N
WAHA	W AA HH AH
WAHAB	W AA HH AH B
WAHAN	W AA AH N
WAHIDMISSION	W AH HH IH D M IH S IY AH N
WAHLA	W AA L AH
WAHN	W AA N
WAIN	W EY N
WAISAY	W EY S EY IY
WAISE	W EY Z
WAIT	W EY T
WAITED	W EY T IH D
WAITING	W EY T IH NG
WAJA	W AA JH AH
WAJAH	W AA JH AH
WAJDAN	W AA JH D AH N
WAJIB	W AA JH AH B
WAJOHAAT	W AA JH AH HH AH T
WALA	W AO L AH
WALAIKUM	W AH L EY K AH M
WALAIKUMALSALAM	W AH L EY K Y AH M AE L S AH L AH M
WALAIKUMSALAM	W AA L AH K AH M Z AH L AH M
WALAY	W AA L EY IY
WALD	W AO L D
WALE	W EY L
WALI	W AA L IY
WALIDAIN	W EY L AH D AH IH N
WALKIUM	W AA L K IY AH M
WALON	W AA L AH N
WALOUN	W AH L AW N
WALVELA	W AA L V AH L AH
WANT	W AA N T
WANT(2)	W AO N T
WAPDA	W AA P D AH
WAQ	W AE K
WAQAI	W AE K EY
WAQAT	W AE K AH T
WAQAYE	W AE K EY
WAQEYE	W AE K EY
WAQFA	W AE K AH
WAQFE	W AE K
WAQFIYAT	W AE K IY AY AH T
WAQIYAH	W AH K IY AY AH
WAQIYATAN	W AE K IY AY EY T AH N
WAQT	W AE K T
WAQUA	W AE K W AH
WARAIJ	W AH R EY JH
WARD	W AO R D
WARGUZAAR	W AO R G Y UW Z EY AH R
WARZISH	W AO R Z AH SH
WAS	W AA Z
WASAIL	W AH S EY L
WASF	W AA S
WASITA	W AA S AH T AH
WASTING	W EY S T IH NG
WATAN	W EY T AH N
WATCH	W AA CH
WATCH(2)	W AO CH
WATCHING	W AA CH IH NG
WATTS	W AA T S
WAVES	W EY V Z
WAY	W EY
WAZAN	W EY Z AH N
WAZEEFA	W EY Z IY F AH
WAZEER	W EY Z IH R
WAZEY	W EY Z IY
WAZIR	W AA Z IH R
WAZIRA	W AA Z AH R AH
WE	W IY
WEARS	W EH R Z
WEB	W EH B
WEBSITE	W EH B S AY T
WEDDING	W EH D IH NG
WEEJI	W IY JH IY
WEHSHAT	W EH SH AH T
WEHSHI	W EH SH IY
WEHSHIANA	W AH SH IY AH N AH
WELCOME	W EH L K AH M
WELDING	W EH L D IH NG
WELFARE	W EH L F EH R
WELL	W EH L
WELLS	W EH L Z
WENT	W EH N T
WERE	W ER
WERENT	W IY R AH N T
WEST	W EH S T
WESTERN	W EH S T ER N
WESTERN(2)	HH W EH S T ER N
WHAT	W AH T
WHAT(2)	HH W AH T
WHEEL	W IY L
WHEEL(2)	HH W IY L
WHEN	W EH N
WHEN(2)	HH W EH N
WHEN(3)	W IH N
WHEN(4)	HH W IH N
WHENYOU	W EH N AY UW
WHERE	W EH R
WHERE(2)	HH W EH R
WHICH	W IH CH
WHICH(2)	HH W IH CH
WHILE	W AY L
WHILE(2)	HH W AY L
WHO	HH UW
WHOLE	HH OW L
WHY	W AY
WHY(2)	HH W AY
WICKET	W IH K AH T
WICKET(2)	HH W IH K AH T
WIFAAQI	W IH F AH K IY
WIFAQ	W IH F AH K
WIFE	W AY F
WIG	W IH G
WILDHOOD	W AY L D HH UH D
WILL	W IH L
WILL(2)	W AH L
WINDOWS	W IH N D OW Z
WING	W IH NG
WIRELESS	W AY R L IH S
WITH	W IH DH
WITH(2)	W IH TH
WITHOUT	W IH TH AW T
WITHOUT(2)	W IH DH AW T
WIZARAT	W IH Z AH R AH T
WLARUS	W L AE R AH S
WO	W OW
WO(2)	HH W OW
WOH	W OW
WOHI	W AA HH IY
WOMEN	W IH M AH N
WOOD	W UH D
WORD	W ER D
WORDS	W ER D Z
WORK	W ER K
WORLD	W ER L D
WOW	W AW
WRESTLING	R EH S L IH NG
WRESTLING(2)	R EH S AH L IH NG
WRITE	R AY T
WRONG	R AO NG
WUFOOD	W UW F UW D
WUJOOD	W UW JH UW D
WUJOOH	W UW JH UW
WUQOOF	W AH K UW F
WUQU	W AH K W
WUSATON	W UW S AH T AH N
WUSOOQ	W UW S AH K
WUZARA	W UW Z AH R AH
X	EH K S
X	EH K S
Y	W AY
Y	W AY
YA	Y AA
YAAD	Y AA D
YAANI	Y AA N IY
YAAR	Y EY AH R
YAB	Y AE B
YADEN	Y EY D AH N
YAE	Y IY
YAHAN	Y AE AH N
YAHI	Y AA HH IY
YAHUDI	Y AE HH Y AH D IY
YAKHNI	Y AE K N IY
YAKSAAN	Y AE K S EY AH N
YAKSAN	Y AE K S AH N
YALGHAMAR	Y AE L AH M AH R
YALGHAR	Y AE L AH R
YANG	Y AE NG
YAQEEN	Y AE K IY AH N
YAQEENAN	Y AH K IY N AH N
YAQEENY	Y AH K IY N IY
YAUM	Y AO M
YAZDANI	Y AE Z D AH N IY
YE	Y IY
YE(2)	Y EH
YEARS	Y IH R Z
YEH	Y EH
YEHI	Y EH HH IY
YELLOW	Y EH L OW
YES	Y EH S
YGANGT	Y G AE N G T
YOGA	Y OW G AH
YOON	Y UW N
YOU	Y UW
YOUNG	Y AH NG
YOUR	Y AO R
YOUR(2)	Y UH R
YUHIN	Y AH HH AH N
Z	Z IY
Z	Z IY
ZAAD	Z AA D
ZAAHIR	Z AA HH AH R
ZAAL	Z EY AH L
ZABAN	Z EY B AH N
ZABARDAST	Z AH B AA R D AH S T
ZABOON	Z AH B UW N
ZADA	Z AA D AH
ZAEEF	Z IY AH F
ZAHEER	Z AE IH R
ZAHID	Z AE HH AH D
ZAHIR	Z AH HH IH R
ZAHOOR	Z AE HH OW AH R
ZAHRILI	Z AE R AH L IY
ZAIB	Z EY B
ZAID	Z EY D
ZAIDI	Z EY D IY
ZAIL	Z EY L
ZAIN	Z EY N
ZAIR	Z AE AH R
ZAKHAIR	Z AE K AH AH R
ZAKHEEM	Z AE K IY M
ZAKHEERA	Z AE K AH R AH
ZAKHMI	Z AE K M IY
ZAL	Z AE L
ZALZALA	Z AE L Z AH L AH
ZALZALAY	Z AE L Z AE L EY IY
ZAMEEN	Z EY M IY AH N
ZANG	Z AE NG
ZANJEER	Z AE N JH IH R
ZANKHON	Z AE NG K AH N
ZAR	Z AA R
ZARAAT	Z AE R AH T
ZAREEFA	Z AH R IY F AH
ZAREYA	Z AE R EY AH
ZARIYE	Z AE R IY AY
ZARKHAIZ	Z AA R K EY Z
ZAROOR	Z AE R OW AH R
ZAROORAT	Z AE R AH R AH T
ZAROORI	Z AE R AH R IY
ZAROORIYAT	Z AE R AH R IY AY AH T
ZARRA	Z AE R AH
ZARYE	Z AE R AY
ZAUF	Z AO F
ZAVIYON	Z EY V IY AY AH N
ZAWAL	Z AO AH L
ZAWAR	Z AO AH R
ZAY	Z EY IY
ZAYA	Z EY AH
ZAYAD	Z EY AH D
ZAYADA	Z EY AH D AH
ZAYD	Z EY D
ZEBRA	Z IY B R AH
ZED	Z EH D
ZEDONG	Z AH D AO NG
ZEESHAN	Z IY SH AH N
ZEGHAM	Z EH AH M
ZEHAN	Z EH AH N
ZEHAR	Z EH AH R
ZEHNI	Z EH N IY
ZENG	Z EH NG
ZER	Z EH R
ZERDAST	Z AH R D AH S T
ZERE	Z IH R
ZEREAAB	Z IY R IY AH B
ZERO	Z IY R OW
ZEWAR	Z UW AH R
ZEWRAAT	Z UW R AH T
ZEY	Z IY IY
ZHAY	Z HH EY IY
ZHEY	Z HH IY IY
ZICH	Z IH CH
ZICHGI	Z IH CH JH IY
ZID	Z IH D
ZIEST	Z AY AH S T
ZIKAR	Z AY K AH R
ZIKR	Z IH K R
ZILAI	Z IH L EY
ZILLA	Z IH L AH
ZINDAGI	Z IH N D AH JH IY
ZIRQYADT	Z AH R K AY AH D T
ZOAJIAT	Z OW JH IY AH T
ZOFASHAN	Z AA F AH SH AH N
ZOJA	Z OW JH AH
ZOJAIN	Z AH JH EY N
ZONE	Z OW N
ZOODHISS	Z UW D HH AH S
ZOODKOSH	Z UW D K AH SH
ZOR	Z AO R
ZOUQ	Z AW K
ZRQAVI	Z R K AE V IY
ZUAAD	Z UW W AH D
ZUAAY	Z UW W AH IY
ZUAD	Z UW W AH D
ZUAMMA	Z UW W AE M AH
ZUBAAN	Z UW B EY AH N
ZUEY	Z UW W IY
ZUFY	Z UW F IY
ZUHAR	Z AH AH R
ZULAIKHA	Z UW L EY K AH
ZULFAIN	Z AH L F EY N
ZULFIQAR	Z AH L F AH K AH R
ZULJALAAL	Z AH L JH AE L EY AH L
ZULJANA	Z AH L JH AH N AH
ZULM	Z AH L M
ZUMRE	Z UW M AH R
ZYADA	Z AY AH D AH
